Family_number,Family_Root,Number_of_members,DNA,RNA,Multi,None,Total_VIP,Num_Critical
1,Bilateria,29,6,4,5,14,15,0
10,Opisthokonta,6,0,1,0,5,1,0
100,Vertebrata,24,1,0,3,20,4,1
1000,Vertebrata,2,0,0,1,1,1,0
10014,LECA,2,0,1,0,1,1,1
1002,Bilateria,14,0,4,1,9,5,0
10032,LECA,2,0,0,0,2,0,0
10036,Homo sapiens,2,0,0,0,2,0,0
10038,LECA,3,0,0,0,3,0,1
1004,Bilateria,3,1,0,0,2,1,0
1005,LECA,14,0,2,0,12,2,0
10051,Homininae,2,0,1,0,1,1,0
10056,Homininae,2,0,0,0,2,0,0
1006,LECA,8,0,4,3,1,7,1
1008,Gnathostomata,3,0,2,1,0,3,1
1009,Vertebrata,3,1,1,1,0,3,1
10094,Eutheria,2,0,0,1,1,1,0
10099,LECA,3,1,0,0,2,1,0
101,LECA,11,2,1,0,8,3,0
1010,LECA,4,0,0,0,4,0,0
1011,LECA,4,1,0,1,2,2,1
10114,Chordata,2,0,0,0,2,0,0
1016,Gnathostomata,4,0,0,1,3,1,0
10167,Gnathostomata,2,1,0,1,0,2,0
10181,Eutheria,2,0,1,0,1,1,1
1019,Vertebrata,2,1,0,1,0,2,0
102,LECA,5,0,0,0,5,0,0
1020,Chordata,3,0,1,1,1,2,0
10226,Gnathostomata,2,0,1,0,1,1,0
1024,Vertebrata,2,0,0,0,2,0,0
10244,Euteleostomi,2,1,1,0,0,2,0
1025,LECA,13,2,1,2,8,5,1
10253,Mammalia,2,0,0,0,2,0,0
10261,Gnathostomata,2,0,0,0,2,0,0
1028,Bilateria,16,1,1,3,11,5,0
10283,Euteleostomi,22,3,0,1,18,4,0
1029,Vertebrata,2,1,0,0,1,1,0
10298,Vertebrata,2,0,0,1,1,1,0
103,LECA,66,8,8,15,35,31,3
1032,LECA,3,0,1,0,2,1,0
1033,LECA,5,1,1,1,2,3,0
1034,LECA,4,0,1,2,1,3,1
10342,Bilateria,2,0,0,0,2,0,0
10353,LECA,4,1,0,1,2,2,0
1037,Vertebrata,3,1,1,0,1,2,0
10377,LECA,2,0,1,0,1,1,0
1038,LECA,2,0,0,1,1,1,0
10381,Homininae,2,0,0,0,2,0,0
104,LECA,35,6,7,1,21,14,3
1042,LECA,18,0,2,0,16,2,0
1043,LECA,7,1,1,0,5,2,1
1044,LECA,2,0,0,0,2,0,0
1046,LECA,4,1,0,0,3,1,0
1047,Opisthokonta,4,0,1,0,3,1,0
1048,LECA,3,0,0,0,3,0,0
1049,Bilateria,5,1,1,0,3,2,0
10506,Gnathostomata,2,0,0,0,2,0,0
1051,LECA,3,2,0,1,0,3,0
1055,Bilateria,3,0,1,0,2,1,0
1059,Bilateria,13,0,2,2,9,4,2
10593,LECA,2,0,0,0,2,0,0
106,Bilateria,4,0,0,0,4,0,0
1060,LECA,23,3,2,6,12,11,1
1062,LECA,3,0,0,2,1,2,0
10624,LECA,2,0,2,0,0,2,0
1064,Gnathostomata,2,0,0,1,1,1,0
10648,Bilateria,2,1,0,0,1,1,0
10652,LECA,3,3,0,0,0,3,0
10697,LECA,2,0,0,0,2,0,1
107,LECA,3,0,1,0,2,1,0
10701,LECA,2,0,0,2,0,2,0
10705,Chordata,2,0,0,0,2,0,0
1071,Bilateria,3,0,0,0,3,0,0
1073,LECA,11,1,2,2,6,5,0
1074,LECA,6,1,2,0,3,3,0
10763,LECA,2,0,0,0,2,0,0
10781,Catarrhini,3,0,0,0,3,0,0
1079,Bilateria,9,0,3,2,4,5,0
10797,Opisthokonta,2,0,1,1,0,2,1
108,LECA,5,1,2,1,1,4,1
1083,Chordata,2,0,0,0,2,0,0
10833,LECA,2,0,1,0,1,1,0
1084,LECA,3,0,1,0,2,1,0
10850,Gnathostomata,2,1,0,0,1,1,0
10854,Mammalia,2,0,0,1,1,1,0
1086,Bilateria,3,1,0,0,2,1,0
1087,LECA,2,0,1,0,1,1,0
10878,Vertebrata,2,0,0,0,2,0,0
10880,Vertebrata,2,0,1,0,1,1,0
10897,Opisthokonta,3,0,1,0,2,1,0
109,LECA,29,2,3,0,24,5,0
1090,LECA,4,2,0,1,1,3,1
10902,LECA,2,0,0,0,2,0,0
10906,Vertebrata,2,2,0,0,0,2,0
1092,Vertebrata,2,0,1,0,1,1,0
1093,Gnathostomata,2,0,0,1,1,1,0
10939,Amniota,2,0,0,1,1,1,0
1094,LECA,3,0,0,1,2,1,0
10950,LECA,2,0,0,0,2,0,0
10964,LECA,2,0,1,0,1,1,0
1097,LECA,3,0,0,0,3,0,0
1098,LECA,3,0,0,1,2,1,1
11,LECA,16,1,1,3,11,5,0
110,Gnathostomata,25,8,1,0,16,9,0
1100,Vertebrata,2,0,0,1,1,1,0
11017,Chordata,2,0,0,1,1,1,1
11043,Eutheria,3,0,0,0,3,0,0
1107,LECA,23,4,3,1,15,8,0
11075,LECA,4,0,1,0,3,1,0
1108,Chordata,2,0,1,0,1,1,0
111,LECA,23,0,2,2,19,4,2
11105,Opisthokonta,3,0,0,2,1,2,0
1111,LECA,4,0,0,0,4,0,0
11118,LECA,4,0,0,0,4,0,0
1112,Bilateria,4,0,1,1,2,2,0
11121,LECA,2,1,0,1,0,2,0
11127,LECA,2,0,1,0,1,1,0
1113,LECA,5,0,2,1,2,3,1
11130,Gnathostomata,2,0,0,1,1,1,0
11131,LECA,3,0,0,0,3,0,0
1115,Euteleostomi,5,2,1,1,1,4,1
1116,LECA,5,0,0,0,5,0,0
1117,Vertebrata,4,0,1,0,3,1,0
11174,Euteleostomi,2,0,0,0,2,0,0
11180,Eutheria,2,0,0,0,2,0,0
1119,Bilateria,4,1,1,0,2,2,0
112,LECA,7,0,1,0,6,1,0
1120,Chordata,3,0,0,0,3,0,1
1121,LECA,6,0,0,2,4,2,0
1122,LECA,3,0,0,0,3,0,0
1124,LECA,8,2,2,0,4,4,0
11250,LECA,2,0,0,1,1,1,0
11255,Eutheria,3,0,0,0,3,0,0
1126,LECA,4,0,0,0,4,0,0
1128,LECA,4,0,1,0,3,1,0
113,LECA,24,1,5,3,15,9,3
1131,LECA,2,1,0,0,1,1,0
1132,LECA,4,0,1,0,3,1,0
1133,LECA,5,2,0,1,2,3,1
1134,LECA,24,5,1,4,14,10,0
11351,Gnathostomata,2,1,0,0,1,1,0
1137,Gnathostomata,8,2,1,0,5,3,0
11373,LECA,2,2,0,0,0,2,0
11379,Eutheria,2,0,0,0,2,0,0
11391,LECA,3,0,0,0,3,0,0
11393,LECA,5,0,1,0,4,1,0
114,LECA,35,3,6,5,21,14,2
1141,LECA,7,0,1,1,5,2,0
1142,Bilateria,2,0,0,1,1,1,0
1143,Opisthokonta,3,0,1,1,1,2,0
11430,LECA,2,0,1,0,1,1,0
1144,LECA,7,3,0,1,3,4,0
1145,Bilateria,5,2,0,1,2,3,1
1149,LECA,3,0,0,0,3,0,1
115,Vertebrata,2,0,0,0,2,0,0
1151,Gnathostomata,2,1,0,0,1,1,0
1159,LECA,7,1,0,3,3,4,0
116,LECA,4,1,0,1,2,2,0
1161,Bilateria,10,1,2,1,6,4,1
11622,LECA,2,1,0,1,0,2,0
1164,Opisthokonta,4,0,1,0,3,1,0
11668,LECA,2,1,0,0,1,1,0
11687,LECA,3,0,0,0,3,0,0
117,Bilateria,26,5,5,1,15,11,1
1172,LECA,2,0,1,0,1,1,0
1173,LECA,6,0,0,1,5,1,0
1174,LECA,14,0,3,1,10,4,0
1177,LECA,3,0,0,0,3,0,0
11771,Bilateria,2,0,0,1,1,1,0
11774,Eutheria,3,0,0,0,3,0,0
1179,LECA,3,0,0,1,2,1,1
118,LECA,5,0,0,0,5,0,0
1180,Gnathostomata,3,1,0,0,2,1,0
11802,Mammalia,6,0,1,1,4,2,0
1185,Bilateria,14,1,1,1,11,3,1
1186,Vertebrata,3,0,0,1,2,1,0
11872,Euteleostomi,2,0,2,0,0,2,1
1188,LECA,3,0,1,1,1,2,0
1189,LECA,6,0,2,1,3,3,0
119,LECA,18,3,4,2,9,9,0
1190,LECA,3,0,1,0,2,1,0
11905,Gnathostomata,2,0,0,0,2,0,0
1191,Vertebrata,3,0,0,0,3,0,0
11911,LECA,2,0,0,0,2,0,0
1194,Gnathostomata,2,0,1,0,1,1,0
11941,Amniota,2,0,0,0,2,0,0
11967,Homininae,2,1,0,0,1,1,0
1197,Bilateria,9,1,1,2,5,4,1
11997,LECA,2,0,1,0,1,1,0
12,LECA,11,2,1,2,6,5,0
120,Vertebrata,2,0,0,1,1,1,0
12039,Amniota,2,0,0,0,2,0,0
1205,Bilateria,7,1,0,2,4,3,0
12055,LECA,2,0,1,0,1,1,0
1206,LECA,2,0,0,0,2,0,0
1210,LECA,7,0,1,0,6,1,1
12115,LECA,2,0,0,0,2,0,0
1213,LECA,8,0,3,2,3,5,1
1216,LECA,4,0,1,0,3,1,0
12169,Gnathostomata,2,0,0,0,2,0,0
1217,LECA,29,2,5,1,21,8,0
1218,LECA,2,0,1,0,1,1,0
1219,Vertebrata,3,0,1,1,1,2,0
122,Opisthokonta,10,0,1,2,7,3,1
1221,Euteleostomi,4,0,1,1,2,2,1
1223,LECA,3,0,1,1,1,2,0
1227,LECA,7,0,0,2,5,2,0
12289,Euteleostomi,2,0,0,0,2,0,0
1229,LECA,5,0,0,2,3,2,0
123,LECA,2,0,0,0,2,0,0
1230,Bilateria,2,0,0,0,2,0,0
12301,LECA,2,0,1,0,1,1,0
12308,Gnathostomata,2,0,0,0,2,0,0
1231,LECA,13,2,2,4,5,8,1
1237,LECA,7,0,1,0,6,1,0
1238,LECA,13,0,0,1,12,1,0
1241,Bilateria,7,0,0,2,5,2,0
12424,Bilateria,2,0,0,0,2,0,0
12428,Vertebrata,2,0,1,0,1,1,0
12446,Vertebrata,2,0,1,0,1,1,0
1245,LECA,12,1,2,3,6,6,0
1246,Gnathostomata,3,1,0,0,2,1,0
1247,LECA,69,8,12,9,40,29,1
125,LECA,2,0,0,1,1,1,0
1250,LECA,6,0,0,0,6,0,0
1252,LECA,4,1,0,0,3,1,0
1253,LECA,2,0,1,1,0,2,0
1256,LECA,4,0,2,0,2,2,0
1257,LECA,3,0,2,1,0,3,0
1258,Bilateria,5,0,0,2,3,2,1
126,Bilateria,8,1,0,1,6,2,1
1261,LECA,5,1,1,2,1,4,0
12615,LECA,2,1,0,0,1,1,0
1262,Gnathostomata,2,0,0,0,2,0,0
1263,LECA,7,0,1,1,5,2,0
12637,Vertebrata,3,0,0,0,3,0,0
1264,Gnathostomata,13,2,0,0,11,2,0
1267,LECA,4,0,0,0,4,0,0
127,Vertebrata,2,0,0,1,1,1,0
1270,LECA,2,0,0,0,2,0,0
1271,Bilateria,3,0,0,0,3,0,0
12770,Eutheria,3,2,0,0,1,2,0
128,LECA,13,0,2,2,9,4,1
12818,Homo sapiens,2,0,0,0,2,0,0
12837,Mammalia,3,0,1,1,1,2,0
12842,LECA,2,0,0,0,2,0,0
12843,Gnathostomata,2,0,0,0,2,0,0
1287,LECA,53,6,2,3,42,11,2
12884,LECA,2,0,0,0,2,0,0
129,Opisthokonta,2,2,0,0,0,2,0
12925,Simiiformes,2,0,0,0,2,0,0
1294,Gnathostomata,3,0,0,0,3,0,0
1297,Vertebrata,2,0,0,0,2,0,0
1298,Bilateria,9,2,0,0,7,2,2
1299,LECA,21,2,5,0,14,7,0
13,LECA,10,0,2,2,6,4,0
130,Bilateria,18,6,1,1,10,8,1
1301,LECA,7,2,2,0,3,4,0
13018,LECA,2,0,0,1,1,1,1
1302,LECA,2,0,0,0,2,0,0
13026,LECA,2,1,1,0,0,2,0
1305,Vertebrata,2,0,0,0,2,0,0
13052,Homo sapiens,3,0,0,0,3,0,0
1307,LECA,11,2,1,1,7,4,0
131,Bilateria,3,0,0,0,3,0,0
1310,Bilateria,18,0,3,1,14,4,1
13122,Catarrhini,2,0,0,0,2,0,0
1313,LECA,2,0,1,0,1,1,0
1314,LECA,8,0,2,4,2,6,0
1315,LECA,2,0,0,0,2,0,0
1316,Opisthokonta,2,0,0,0,2,0,0
1317,LECA,9,1,2,0,6,3,0
1319,Vertebrata,2,1,1,0,0,2,0
1322,LECA,5,1,0,2,2,3,1
1323,LECA,3,0,1,1,1,2,0
1324,Bilateria,6,0,2,1,3,3,0
1326,LECA,6,0,0,1,5,1,0
1327,Vertebrata,7,1,1,1,4,3,0
13287,Vertebrata,2,0,1,0,1,1,0
1329,LECA,3,0,0,0,3,0,0
133,LECA,8,0,1,1,6,2,1
1330,Opisthokonta,2,1,0,0,1,1,0
1331,Mammalia,2,0,0,0,2,0,0
1333,LECA,9,1,0,1,7,2,0
1335,LECA,7,1,0,1,5,2,0
1336,LECA,6,0,1,1,4,2,0
1339,LECA,27,5,2,0,20,7,2
134,Bilateria,15,0,2,0,13,2,1
1341,Opisthokonta,2,0,0,1,1,1,0
1343,LECA,4,0,0,1,3,1,0
1344,LECA,5,0,1,1,3,2,0
13453,Opisthokonta,2,0,1,0,1,1,0
1346,LECA,17,4,0,3,10,7,0
1347,LECA,3,0,0,2,1,2,0
135,Bilateria,5,0,0,0,5,0,0
13508,Bilateria,3,0,0,0,3,0,0
1351,LECA,12,1,1,0,10,2,0
1352,Vertebrata,3,1,0,1,1,2,0
1353,Vertebrata,2,1,0,0,1,1,0
1354,Bilateria,10,3,0,0,7,3,0
13552,Gnathostomata,2,0,0,0,2,0,0
1357,LECA,3,0,0,0,3,0,0
13572,Bilateria,2,1,0,0,1,1,0
1358,Vertebrata,3,0,1,0,2,1,0
1359,LECA,3,0,0,0,3,0,0
136,LECA,43,5,6,5,27,16,1
1360,LECA,2,1,0,0,1,1,0
1363,LECA,4,0,0,2,2,2,1
1364,Vertebrata,3,0,1,2,0,3,0
13646,Homininae,2,1,1,0,0,2,0
1366,Chordata,3,0,0,0,3,0,0
1368,Vertebrata,2,0,0,0,2,0,0
137,LECA,8,0,1,0,7,1,1
1372,LECA,2,0,0,0,2,0,0
1373,LECA,5,1,1,0,3,2,0
1374,Chordata,2,1,0,0,1,1,0
1376,Opisthokonta,2,0,0,1,1,1,0
1377,LECA,11,0,3,0,8,3,1
138,LECA,27,3,7,7,10,17,3
1381,Catarrhini,2,0,0,0,2,0,0
1386,LECA,9,1,2,1,5,4,0
1387,LECA,5,1,0,3,1,4,0
1389,LECA,19,3,2,6,8,11,0
139,Bilateria,2,0,0,0,2,0,0
1390,LECA,3,0,1,0,2,1,0
1391,LECA,3,0,0,0,3,0,0
1393,Opisthokonta,2,0,0,0,2,0,0
1394,LECA,4,0,2,1,1,3,0
1395,LECA,2,0,0,0,2,0,0
1397,LECA,2,0,0,0,2,0,1
14,Bilateria,2,1,0,0,1,1,0
1402,Opisthokonta,5,0,1,1,3,2,0
1403,LECA,2,0,0,0,2,0,0
1404,LECA,7,2,0,1,4,3,0
1406,LECA,5,1,0,1,3,2,1
141,LECA,4,0,0,1,3,1,0
1411,Gnathostomata,2,1,0,0,1,1,0
1412,LECA,11,2,2,1,6,5,0
1416,LECA,10,0,4,0,6,4,0
1417,LECA,2,0,0,0,2,0,1
1418,LECA,3,0,0,0,3,0,0
142,Chordata,2,0,0,1,1,1,0
1428,Gnathostomata,2,0,0,1,1,1,0
143,Vertebrata,18,2,2,1,13,5,1
1430,LECA,2,0,0,0,2,0,0
1432,Bilateria,2,0,0,0,2,0,0
1437,Opisthokonta,5,0,0,1,4,1,0
144,LECA,26,2,5,1,18,8,1
1441,Tetrapoda,9,1,1,1,6,3,0
1442,LECA,5,0,1,0,4,1,0
1445,LECA,10,2,1,1,6,4,0
1447,Bilateria,3,0,0,1,2,1,0
145,LECA,6,0,1,1,4,2,0
1451,Opisthokonta,4,1,1,0,2,2,0
1452,LECA,3,1,0,0,2,1,0
1454,LECA,3,0,0,0,3,0,0
1457,Opisthokonta,4,0,0,0,4,0,0
1458,LECA,11,0,0,1,10,1,0
1459,LECA,2,1,0,0,1,1,0
146,LECA,14,1,1,1,11,3,0
1460,LECA,2,0,0,0,2,0,0
1461,Tetrapoda,20,1,2,4,13,7,2
1467,LECA,7,0,0,1,6,1,0
1468,Chordata,5,0,0,0,5,0,0
147,Bilateria,5,0,0,0,5,0,0
1471,LECA,5,2,0,1,2,3,0
1472,LECA,11,1,2,0,8,3,0
1473,Bilateria,3,0,0,0,3,0,0
1474,Opisthokonta,10,3,3,2,2,8,1
1477,Bilateria,3,0,0,0,3,0,0
1479,Eutheria,3,0,0,0,3,0,0
148,LECA,6,2,1,0,3,3,0
1480,Vertebrata,2,0,0,0,2,0,0
1485,LECA,4,0,0,0,4,0,0
1488,Vertebrata,4,1,1,0,2,2,0
1489,LECA,8,1,1,0,6,2,0
149,Gnathostomata,2,0,1,0,1,1,0
1492,LECA,2,0,0,0,2,0,0
1493,LECA,2,0,0,0,2,0,0
1494,LECA,9,2,1,0,6,3,1
1496,Amniota,4,0,1,0,3,1,0
1499,Bilateria,3,0,1,0,2,1,0
15,LECA,2,0,0,0,2,0,0
1503,LECA,4,1,0,0,3,1,0
1504,Opisthokonta,2,0,1,0,1,1,0
1505,LECA,3,2,0,1,0,3,0
1506,LECA,3,0,0,0,3,0,0
1510,Euteleostomi,2,0,0,0,2,0,0
1511,Opisthokonta,3,0,1,1,1,2,0
1514,Bilateria,3,0,0,0,3,0,0
1518,Euteleostomi,5,0,3,0,2,3,0
152,Euteleostomi,2,0,0,1,1,1,0
1520,Bilateria,2,1,0,0,1,1,0
1521,Bilateria,13,2,3,1,7,6,0
1523,LECA,6,1,1,2,2,4,1
1524,Chordata,3,0,0,0,3,0,0
1525,LECA,2,1,0,0,1,1,0
15262,Simiiformes,2,0,0,0,2,0,0
1527,Chordata,11,2,4,0,5,6,1
1528,Vertebrata,2,1,0,0,1,1,0
1529,Gnathostomata,2,0,0,0,2,0,0
1532,LECA,2,1,1,0,0,2,1
1533,LECA,5,2,1,0,2,3,0
1534,Chordata,3,0,1,0,2,1,0
1536,Bilateria,6,0,1,1,4,2,0
1537,Gnathostomata,2,0,0,2,0,2,0
1541,LECA,3,1,1,0,1,2,0
1547,Opisthokonta,3,0,0,0,3,0,0
1549,LECA,3,1,0,1,1,2,0
155,LECA,5,0,0,3,2,3,1
1550,LECA,5,0,1,0,4,1,0
1551,Bilateria,6,1,1,1,3,3,1
1555,Gnathostomata,3,0,0,0,3,0,0
1556,LECA,11,0,2,0,9,2,0
1557,LECA,3,0,1,2,0,3,0
1559,LECA,2,0,0,1,1,1,1
1560,LECA,2,0,1,0,1,1,0
1562,LECA,4,0,1,1,2,2,0
1564,Bilateria,14,1,0,0,13,1,0
1565,Bilateria,5,0,0,1,4,1,0
1568,Bilateria,8,0,0,2,6,2,1
157,LECA,4,0,0,1,3,1,0
1570,LECA,3,0,1,1,1,2,0
1574,LECA,8,0,1,0,7,1,0
1575,Vertebrata,3,1,1,0,1,2,0
1576,Bilateria,6,2,0,0,4,2,0
1577,LECA,2,0,0,0,2,0,0
1578,LECA,2,1,0,0,1,1,0
158,Opisthokonta,6,2,0,0,4,2,0
1581,Bilateria,5,2,1,1,1,4,0
1583,Bilateria,2,0,0,1,1,1,0
1587,LECA,6,0,2,0,4,2,0
1589,Opisthokonta,7,1,0,3,3,4,0
159,LECA,3,0,2,1,0,3,0
1591,Opisthokonta,4,2,0,0,2,2,0
1598,Opisthokonta,3,0,1,1,1,2,0
16,Euteleostomi,2,1,0,0,1,1,0
160,Bilateria,4,0,0,0,4,0,0
1606,Opisthokonta,11,0,4,0,7,4,1
161,LECA,2,0,0,0,2,0,0
1612,LECA,7,0,1,1,5,2,0
1613,Chordata,3,1,0,2,0,3,0
1615,LECA,4,0,0,1,3,1,0
1617,Bilateria,5,1,0,1,3,2,0
1625,LECA,6,0,2,1,3,3,0
1626,Gnathostomata,2,0,0,1,1,1,0
1628,Bilateria,7,2,0,0,5,2,0
1629,LECA,5,0,0,2,3,2,1
163,Chordata,4,0,1,1,2,2,1
1630,Vertebrata,3,0,0,1,2,1,1
1635,LECA,4,1,0,1,2,2,1
1637,Opisthokonta,4,0,0,1,3,1,0
1639,Bilateria,7,3,0,0,4,3,1
1640,LECA,5,0,0,1,4,1,0
1641,Bilateria,4,0,0,0,4,0,0
1642,Bilateria,5,1,1,0,3,2,0
1643,LECA,2,0,0,1,1,1,0
1646,Bilateria,31,2,5,2,22,9,2
1648,LECA,3,0,0,0,3,0,0
1649,LECA,3,0,0,1,2,1,0
165,LECA,19,1,2,3,13,6,0
1650,Vertebrata,2,0,0,0,2,0,0
1651,LECA,11,2,2,0,7,4,1
1652,Vertebrata,2,0,0,0,2,0,0
1654,LECA,7,2,1,1,3,4,0
1656,Vertebrata,12,1,0,3,8,4,0
166,Bilateria,5,1,0,0,4,1,0
1660,LECA,4,0,1,0,3,1,0
1662,LECA,9,1,2,1,5,4,0
1668,Chordata,3,0,0,1,2,1,0
167,LECA,11,5,1,0,5,6,0
1674,Vertebrata,3,1,1,0,1,2,0
16749,Gnathostomata,4,0,0,0,4,0,0
1678,Opisthokonta,2,0,0,0,2,0,0
168,LECA,6,1,2,0,3,3,0
1685,LECA,7,1,0,0,6,1,0
1686,LECA,13,1,2,1,9,4,1
16861,Hominoidea,2,1,0,0,1,1,0
1687,LECA,2,0,1,0,1,1,0
169,LECA,8,4,1,2,1,7,1
1690,LECA,3,0,1,1,1,2,0
1691,LECA,2,0,0,0,2,0,0
1694,Gnathostomata,12,0,1,1,10,2,0
1696,LECA,9,1,1,3,4,5,0
17,LECA,6,1,0,1,4,2,0
170,LECA,18,0,0,14,4,14,1
1700,Opisthokonta,7,1,0,3,3,4,0
1701,LECA,3,0,1,0,2,1,0
1702,LECA,2,0,1,0,1,1,0
1703,Amniota,2,0,0,0,2,0,0
1705,LECA,7,1,1,1,4,3,0
1706,Bilateria,6,1,0,0,5,1,0
171,Bilateria,3,0,0,0,3,0,0
1710,LECA,9,1,0,5,3,6,1
1714,Chordata,3,0,0,1,2,1,0
1717,LECA,5,0,1,1,3,2,0
1718,LECA,10,2,2,2,4,6,0
1719,LECA,2,0,0,0,2,0,0
172,LECA,9,0,2,2,5,4,1
1721,LECA,4,0,1,0,3,1,1
1725,Vertebrata,5,1,0,1,3,2,0
1727,LECA,19,2,2,3,12,7,0
1728,Vertebrata,3,0,0,0,3,0,0
1731,Bilateria,5,0,0,1,4,1,0
1738,Chordata,3,1,1,1,0,3,1
1745,LECA,19,1,2,4,12,7,0
1746,LECA,2,0,1,1,0,2,0
1747,LECA,6,2,0,2,2,4,0
1748,Bilateria,2,0,0,1,1,1,0
1750,Opisthokonta,2,0,0,0,2,0,0
1752,LECA,2,0,0,0,2,0,1
17534,Bilateria,2,0,1,0,1,1,0
1755,LECA,4,0,1,0,3,1,0
1756,LECA,3,1,0,0,2,1,0
17563,Catarrhini,2,0,1,1,0,2,0
176,Vertebrata,4,1,1,0,2,2,1
1760,Vertebrata,2,1,0,0,1,1,1
1762,LECA,2,0,1,0,1,1,0
1766,Vertebrata,2,1,0,1,0,2,1
1773,LECA,3,0,0,1,2,1,0
1777,LECA,3,1,1,0,1,2,0
1778,LECA,6,1,1,1,3,3,0
178,LECA,2,0,1,0,1,1,0
1780,LECA,5,1,0,0,4,1,0
1782,LECA,2,1,0,0,1,1,1
1784,Opisthokonta,3,1,1,0,1,2,0
1786,LECA,3,0,1,1,1,2,0
179,LECA,15,2,2,2,9,6,1
1790,LECA,16,4,3,0,9,7,1
1792,LECA,2,0,0,1,1,1,1
1795,Bilateria,4,1,0,1,2,2,0
1796,LECA,4,1,0,1,2,2,0
1799,LECA,7,0,0,0,7,0,0
18,Gnathostomata,3,1,0,0,2,1,0
180,Bilateria,17,6,1,1,9,8,0
1800,Bilateria,2,0,0,1,1,1,0
18009,Gnathostomata,3,0,0,0,3,0,1
1809,LECA,2,0,1,0,1,1,1
181,Vertebrata,4,1,0,0,3,1,0
1810,LECA,3,1,0,0,2,1,1
1818,LECA,3,0,1,0,2,1,0
1819,LECA,6,0,2,0,4,2,0
182,LECA,3,0,1,0,2,1,0
1820,LECA,13,1,1,2,9,4,0
1821,LECA,13,2,3,3,5,8,1
1822,Bilateria,9,0,0,1,8,1,1
1824,LECA,3,1,0,0,2,1,0
1828,LECA,2,0,0,0,2,0,0
1829,Euteleostomi,3,0,0,0,3,0,0
183,LECA,2,0,0,0,2,0,0
1830,Chordata,2,1,0,0,1,1,0
1832,Bilateria,3,1,0,0,2,1,0
1835,LECA,3,0,1,0,2,1,0
1839,Chordata,2,0,0,0,2,0,0
184,LECA,6,2,1,1,2,4,0
1841,Vertebrata,3,0,1,0,2,1,0
1842,LECA,11,2,0,1,8,3,0
1847,LECA,4,1,0,0,3,1,0
1848,Vertebrata,2,0,1,0,1,1,0
185,LECA,9,1,1,0,7,2,0
1850,Gnathostomata,9,1,2,1,5,4,0
1856,Bilateria,2,0,0,0,2,0,0
1857,LECA,16,0,6,0,10,6,1
1858,LECA,2,1,0,0,1,1,0
186,LECA,3,0,0,1,2,1,0
1860,Chordata,4,1,1,2,0,4,0
1863,Gnathostomata,2,0,1,0,1,1,0
1864,Euteleostomi,6,3,0,0,3,3,0
187,LECA,4,0,0,2,2,2,1
1876,LECA,2,1,1,0,0,2,0
188,Chordata,2,1,0,0,1,1,0
1880,Gnathostomata,2,0,0,1,1,1,0
1881,Vertebrata,2,1,1,0,0,2,0
1882,LECA,5,0,0,2,3,2,0
1885,LECA,2,0,1,0,1,1,0
1888,LECA,16,0,2,0,14,2,0
1889,LECA,2,0,1,1,0,2,0
189,Opisthokonta,2,0,0,1,1,1,0
1890,Opisthokonta,3,0,0,0,3,0,0
1891,LECA,3,2,0,1,0,3,0
1892,LECA,2,1,0,0,1,1,1
1893,Bilateria,2,1,0,0,1,1,0
1896,LECA,4,0,1,1,2,2,0
19,Bilateria,17,3,1,1,12,5,0
190,Bilateria,2,0,0,1,1,1,0
1900,Bilateria,6,0,1,0,5,1,0
1906,LECA,11,2,2,0,7,4,0
1908,LECA,5,0,0,0,5,0,0
191,Vertebrata,4,0,0,1,3,1,0
1911,LECA,2,1,0,1,0,2,0
1917,LECA,2,1,0,0,1,1,0
1918,Vertebrata,2,0,0,0,2,0,1
192,Chordata,14,2,2,2,8,6,2
1921,Bilateria,3,0,1,1,1,2,1
1923,Chordata,2,0,1,0,1,1,0
1924,LECA,3,1,0,0,2,1,0
1925,LECA,16,2,4,1,9,7,0
1928,LECA,2,0,1,1,0,2,0
193,LECA,23,1,3,2,17,6,1
1932,LECA,6,0,1,0,5,1,0
1933,LECA,18,4,2,1,11,7,0
1935,Bilateria,8,2,0,1,5,3,1
1937,LECA,9,1,2,4,2,7,0
1938,LECA,3,0,0,1,2,1,0
194,LECA,10,0,1,0,9,1,0
1940,LECA,7,0,1,0,6,1,0
1942,Mammalia,3,1,1,1,0,3,0
1943,Bilateria,3,1,0,0,2,1,0
1944,Bilateria,8,0,2,0,6,2,0
1949,LECA,2,0,0,0,2,0,0
195,Bilateria,11,0,2,0,9,2,0
1951,LECA,3,1,0,0,2,1,0
1952,LECA,2,1,0,0,1,1,0
1955,LECA,3,0,0,1,2,1,0
1957,LECA,2,0,1,0,1,1,0
196,LECA,23,4,2,3,14,9,0
1960,Vertebrata,2,0,0,0,2,0,0
1964,Bilateria,5,0,0,1,4,1,2
1965,Vertebrata,2,0,1,0,1,1,0
1967,Bilateria,3,1,0,0,2,1,0
1968,LECA,3,0,0,1,2,1,0
197,Vertebrata,2,0,2,0,0,2,0
1970,LECA,2,1,0,1,0,2,0
1971,LECA,4,1,1,0,2,2,0
1972,LECA,3,0,1,1,1,2,1
1977,Opisthokonta,5,1,1,1,2,3,0
1984,Bilateria,12,4,1,1,6,6,0
1985,Vertebrata,4,0,0,1,3,1,0
199,Opisthokonta,4,1,1,0,2,2,0
1993,Gnathostomata,2,0,1,0,1,1,0
1994,Bilateria,8,1,2,1,4,4,0
1995,LECA,3,0,0,0,3,0,0
1997,LECA,3,0,0,1,2,1,0
2,Gnathostomata,2,0,0,1,1,1,0
20,LECA,24,3,1,2,18,6,0
200,LECA,5,1,0,1,3,2,0
2000,LECA,13,2,1,1,9,4,0
2003,Opisthokonta,3,1,0,0,2,1,0
2005,LECA,5,0,1,1,3,2,0
2008,Bilateria,14,2,1,1,10,4,1
2009,LECA,3,0,0,0,3,0,0
2015,Theria,2,0,0,1,1,1,0
202,LECA,3,0,2,0,1,2,0
2020,Vertebrata,2,0,0,0,2,0,1
2021,Chordata,2,0,0,0,2,0,0
2022,Opisthokonta,3,2,0,0,1,2,0
2023,LECA,5,0,0,1,4,1,0
2024,LECA,2,1,1,0,0,2,0
203,Bilateria,3,1,0,0,2,1,0
2032,Vertebrata,4,0,0,0,4,0,0
2033,LECA,2,1,0,0,1,1,0
2036,Gnathostomata,2,0,1,0,1,1,0
204,LECA,3,0,2,0,1,2,0
2041,Chordata,3,0,0,0,3,0,0
2042,Gnathostomata,3,0,0,0,3,0,0
2043,Vertebrata,2,0,1,0,1,1,0
2044,LECA,14,2,0,1,11,3,0
2045,LECA,8,1,1,1,5,3,1
2048,LECA,4,0,0,0,4,0,0
205,LECA,4,1,1,1,1,3,0
2052,Bilateria,4,0,0,0,4,0,0
2056,LECA,6,0,1,0,5,1,0
2057,Bilateria,2,0,1,0,1,1,0
2058,LECA,5,0,3,1,1,4,0
206,Bilateria,4,1,0,0,3,1,1
2061,LECA,3,0,0,0,3,0,0
2067,Euteleostomi,2,1,0,0,1,1,0
207,LECA,12,1,2,0,9,3,0
2070,LECA,3,0,0,2,1,2,0
2071,Vertebrata,2,0,1,0,1,1,1
2072,Vertebrata,7,0,0,0,7,0,0
2077,Vertebrata,2,1,0,0,1,1,0
208,LECA,4,1,0,0,3,1,0
2083,Opisthokonta,2,0,2,0,0,2,0
2084,LECA,4,0,3,0,1,3,0
2088,Vertebrata,5,0,0,0,5,0,0
2089,Bilateria,8,2,1,2,3,5,2
2090,Bilateria,7,1,1,1,4,3,0
2092,LECA,5,2,1,0,2,3,0
2093,Bilateria,2,1,0,0,1,1,0
2094,LECA,6,1,1,1,3,3,0
2095,LECA,2,0,0,0,2,0,0
2096,Gnathostomata,2,0,0,1,1,1,0
2099,LECA,16,1,2,5,8,8,0
21,LECA,5,0,0,2,3,2,1
2103,LECA,4,1,2,0,1,3,0
2109,LECA,2,1,1,0,0,2,0
211,LECA,13,2,2,1,8,5,1
2111,LECA,3,1,1,0,1,2,0
2115,LECA,5,2,2,0,1,4,0
2117,LECA,2,0,1,0,1,1,0
2119,LECA,2,0,0,0,2,0,0
212,LECA,7,1,0,1,5,2,0
2129,LECA,4,2,0,0,2,2,0
213,LECA,3,0,1,1,1,2,0
2134,LECA,3,1,1,0,1,2,0
2135,Opisthokonta,5,2,0,0,3,2,0
2139,Vertebrata,3,0,0,0,3,0,0
2142,Bilateria,3,0,0,1,2,1,0
2146,LECA,3,0,0,0,3,0,0
2147,LECA,3,0,0,1,2,1,1
2149,LECA,5,2,0,0,3,2,0
2150,LECA,2,0,0,0,2,0,0
2151,LECA,2,1,0,0,1,1,0
2153,LECA,2,1,0,0,1,1,0
2154,Opisthokonta,7,0,2,0,5,2,0
2155,Gnathostomata,2,0,0,0,2,0,0
2156,LECA,2,1,0,0,1,1,0
2157,Bilateria,6,1,0,0,5,1,0
2158,LECA,10,1,0,4,5,5,1
216,LECA,2,0,0,0,2,0,0
2164,LECA,3,2,1,0,0,3,1
2166,Gnathostomata,3,1,1,0,1,2,0
2167,Chordata,9,4,0,1,4,5,0
217,Gnathostomata,2,0,0,0,2,0,0
2173,LECA,2,0,0,2,0,2,0
2174,LECA,5,0,0,1,4,1,0
2183,LECA,2,0,0,0,2,0,0
2184,LECA,2,0,0,0,2,0,0
2185,Bilateria,9,1,1,2,5,4,0
2186,Bilateria,4,0,1,0,3,1,0
2189,Bilateria,8,1,0,0,7,1,1
219,LECA,4,1,2,1,0,4,0
2190,Gnathostomata,2,0,0,0,2,0,0
2191,Chordata,3,1,1,0,1,2,0
2195,Gnathostomata,2,0,0,0,2,0,0
2199,LECA,2,0,1,0,1,1,0
22,LECA,16,3,1,0,12,4,1
2202,Bilateria,3,0,1,0,2,1,0
2209,Bilateria,6,0,0,1,5,1,0
221,Bilateria,2,0,1,0,1,1,0
2211,Bilateria,4,0,1,0,3,1,0
2215,LECA,2,0,0,0,2,0,0
2218,LECA,7,1,1,1,4,3,1
222,LECA,3,1,0,1,1,2,0
2226,Bilateria,2,0,0,0,2,0,0
223,Bilateria,12,2,0,0,10,2,0
2230,LECA,8,1,2,0,5,3,1
2232,Opisthokonta,3,0,0,0,3,0,0
2235,LECA,3,0,0,0,3,0,0
2236,LECA,3,1,1,0,1,2,0
2239,LECA,2,0,0,0,2,0,0
2240,LECA,9,0,1,1,7,2,0
2243,LECA,3,0,0,3,0,3,0
2244,LECA,3,0,0,0,3,0,0
2246,Vertebrata,3,0,0,0,3,0,0
2247,LECA,2,0,0,0,2,0,0
2249,LECA,2,0,0,1,1,1,0
225,LECA,4,1,0,0,3,1,0
2252,LECA,2,0,0,1,1,1,0
2254,Gnathostomata,3,0,0,0,3,0,0
226,LECA,2,0,1,0,1,1,0
2261,Bilateria,3,0,1,1,1,2,0
2265,Homo sapiens,3,0,0,0,3,0,0
227,LECA,9,0,0,0,9,0,0
2273,Gnathostomata,2,0,0,0,2,0,0
2279,Chordata,4,0,0,1,3,1,0
2286,LECA,11,2,1,1,7,4,0
2287,Opisthokonta,3,0,1,0,2,1,0
229,Gnathostomata,20,1,2,4,13,7,0
230,Bilateria,19,1,1,2,15,4,2
2308,Bilateria,6,0,0,0,6,0,0
2310,Vertebrata,2,0,0,0,2,0,0
232,LECA,14,1,5,0,8,6,0
2322,LECA,2,0,0,0,2,0,0
2324,Opisthokonta,4,0,1,1,2,2,0
2325,Gnathostomata,2,1,0,0,1,1,0
2328,LECA,4,0,0,1,3,1,0
2329,LECA,4,0,1,0,3,1,0
2332,Bilateria,2,0,0,0,2,0,0
2334,Vertebrata,3,0,1,1,1,2,0
2335,Bilateria,2,0,0,0,2,0,0
2336,LECA,4,0,1,1,2,2,0
2337,Vertebrata,2,0,0,1,1,1,0
234,Eutheria,3,0,0,1,2,1,0
2340,Opisthokonta,2,0,0,0,2,0,0
2341,Euteleostomi,2,0,0,1,1,1,0
2342,Opisthokonta,9,2,0,0,7,2,0
2346,Opisthokonta,3,0,0,0,3,0,0
2348,LECA,3,1,0,0,2,1,0
2349,Vertebrata,2,0,0,0,2,0,0
235,Opisthokonta,3,0,0,1,2,1,0
2351,LECA,15,0,5,4,6,9,1
2352,LECA,4,1,0,0,3,1,0
2355,LECA,2,0,1,0,1,1,0
2357,LECA,5,0,0,1,4,1,2
236,LECA,7,1,0,0,6,1,0
2361,Opisthokonta,2,0,0,0,2,0,0
2363,LECA,4,0,0,0,4,0,0
237,Vertebrata,5,1,1,1,2,3,0
2377,Bilateria,2,0,0,0,2,0,0
238,LECA,9,2,2,1,4,5,0
2382,LECA,4,0,1,0,3,1,0
2383,LECA,3,0,0,2,1,2,1
2384,LECA,12,2,0,6,4,8,0
2386,LECA,3,1,0,0,2,1,0
2387,LECA,7,2,0,0,5,2,0
2389,LECA,2,0,0,0,2,0,0
2390,Bilateria,2,1,0,0,1,1,0
2393,LECA,5,0,0,1,4,1,0
24,LECA,51,11,8,6,26,25,0
2403,Bilateria,2,0,0,0,2,0,0
2404,Gnathostomata,2,1,0,1,0,2,0
2409,Bilateria,4,0,0,0,4,0,0
241,LECA,5,0,0,1,4,1,0
2410,Vertebrata,2,1,0,0,1,1,0
2412,Bilateria,7,0,1,0,6,1,0
242,LECA,3,0,1,0,2,1,0
2421,Opisthokonta,2,0,0,0,2,0,0
2425,LECA,4,1,0,1,2,2,0
2428,Bilateria,3,0,1,1,1,2,0
2429,Chordata,4,0,3,0,1,3,0
243,LECA,12,3,1,0,8,4,0
2432,Chordata,3,1,0,0,2,1,0
2436,Bilateria,5,1,0,0,4,1,2
2437,Vertebrata,3,0,1,1,1,2,0
2438,LECA,2,1,0,0,1,1,0
2439,LECA,3,0,1,1,1,2,0
244,Gnathostomata,3,0,1,0,2,1,1
2448,Bilateria,2,0,0,0,2,0,0
2449,LECA,2,0,0,0,2,0,0
2456,LECA,2,0,0,0,2,0,0
2458,LECA,2,0,0,0,2,0,0
2459,LECA,3,2,1,0,0,3,0
246,Bilateria,3,0,0,0,3,0,1
2467,LECA,2,0,0,0,2,0,0
247,LECA,6,1,0,2,3,3,1
2473,LECA,18,1,2,4,11,7,1
2474,Opisthokonta,2,0,0,1,1,1,0
2475,LECA,6,0,1,2,3,3,0
2477,LECA,2,0,0,0,2,0,0
248,LECA,10,0,1,2,7,3,1
2483,LECA,3,1,0,0,2,1,0
2488,Chordata,4,0,0,1,3,1,0
2489,LECA,4,0,1,1,2,2,0
249,LECA,28,4,3,2,19,9,1
2492,LECA,5,0,1,0,4,1,0
2495,LECA,3,0,1,0,2,1,0
2499,Gnathostomata,2,0,0,1,1,1,0
250,LECA,8,1,0,1,6,2,0
2500,LECA,3,0,1,1,1,2,0
2501,LECA,3,0,0,2,1,2,0
2503,LECA,4,0,2,0,2,2,0
2505,LECA,5,0,0,1,4,1,1
2509,Vertebrata,9,0,2,3,4,5,0
251,LECA,10,0,1,3,6,4,1
2519,Gnathostomata,2,0,1,0,1,1,0
252,Amniota,3,0,0,0,3,0,0
2520,LECA,3,0,0,1,2,1,0
2522,LECA,13,0,2,1,10,3,0
2524,Chordata,2,0,1,0,1,1,0
253,Bilateria,3,0,1,0,2,1,0
2530,LECA,18,0,1,1,16,2,0
2532,Vertebrata,3,0,1,1,1,2,0
2533,Bilateria,3,0,0,0,3,0,0
2537,LECA,7,0,0,0,7,0,0
254,LECA,48,8,6,3,31,17,0
2542,Bilateria,3,1,1,0,1,2,0
2543,LECA,4,0,0,0,4,0,0
2546,LECA,2,0,0,1,1,1,0
255,LECA,38,1,6,2,29,9,1
2552,LECA,3,1,0,2,0,3,0
2558,Gnathostomata,2,0,0,0,2,0,0
256,LECA,18,2,2,2,12,6,2
2563,Opisthokonta,6,0,1,0,5,1,0
2564,Bilateria,3,1,0,0,2,1,0
2568,Chordata,3,0,0,0,3,0,1
257,LECA,2,0,0,0,2,0,0
2574,LECA,2,0,0,0,2,0,0
2576,Gnathostomata,2,0,0,0,2,0,0
2578,Gnathostomata,3,1,0,1,1,2,0
258,LECA,13,3,2,3,5,8,1
2582,LECA,12,0,1,0,11,1,1
2583,Gnathostomata,2,0,0,0,2,0,0
259,LECA,2,0,1,1,0,2,1
26,Vertebrata,2,0,1,1,0,2,0
2601,Vertebrata,2,0,0,0,2,0,0
2607,LECA,4,0,0,1,3,1,0
2608,LECA,4,0,0,1,3,1,0
261,LECA,36,4,3,4,25,11,1
2610,Eutheria,2,0,1,1,0,2,0
2612,Gnathostomata,2,1,0,0,1,1,0
2613,Vertebrata,5,0,1,0,4,1,0
2614,Euteleostomi,2,0,0,0,2,0,0
2618,LECA,3,0,0,0,3,0,1
262,Bilateria,41,4,1,0,36,5,3
2622,Chordata,3,0,2,1,0,3,0
2625,Vertebrata,2,1,0,0,1,1,0
263,Gnathostomata,15,1,1,2,11,4,0
2634,LECA,2,0,0,1,1,1,0
2640,Bilateria,2,0,0,1,1,1,0
2648,LECA,6,0,1,0,5,1,0
265,LECA,2,0,0,0,2,0,0
2651,LECA,2,0,0,0,2,0,0
2657,Opisthokonta,2,0,0,0,2,0,0
266,Bilateria,4,1,0,1,2,2,0
2660,Chordata,5,0,0,0,5,0,1
2661,LECA,2,0,0,0,2,0,0
2665,Opisthokonta,3,2,0,0,1,2,0
2667,LECA,2,0,0,0,2,0,0
267,LECA,5,1,0,1,3,2,1
268,Bilateria,19,2,4,1,12,7,1
2683,Bilateria,2,0,0,0,2,0,0
2687,Vertebrata,3,0,0,1,2,1,0
269,LECA,7,0,1,2,4,3,0
2692,Vertebrata,3,0,0,0,3,0,0
2699,Vertebrata,3,0,2,0,1,2,0
27,Bilateria,2,0,0,0,2,0,0
270,LECA,6,0,0,0,6,0,1
2701,Euteleostomi,2,0,0,1,1,1,0
2702,Gnathostomata,6,0,0,0,6,0,0
2707,Vertebrata,2,0,0,0,2,0,0
2709,Vertebrata,3,1,0,0,2,1,0
2712,LECA,5,0,1,3,1,4,0
272,LECA,3,0,1,1,1,2,0
2720,Gnathostomata,2,0,0,0,2,0,0
2725,Eutheria,5,0,0,0,5,0,0
2727,Bilateria,4,1,0,0,3,1,0
2731,LECA,12,2,1,0,9,3,0
2732,Bilateria,9,0,0,3,6,3,2
2738,LECA,18,3,1,1,13,5,1
2740,Gnathostomata,2,0,0,1,1,1,0
2745,Eutheria,3,2,0,0,1,2,0
275,LECA,10,0,2,0,8,2,1
2750,Bilateria,3,1,0,0,2,1,0
2754,LECA,2,0,1,0,1,1,0
276,LECA,6,0,0,5,1,5,0
2761,Bilateria,3,0,0,0,3,0,0
2762,LECA,7,0,2,2,3,4,1
2768,Vertebrata,8,0,1,2,5,3,1
277,LECA,5,0,0,0,5,0,0
2773,Opisthokonta,2,1,0,0,1,1,0
2776,LECA,7,1,2,1,3,4,0
2782,Chordata,3,1,0,0,2,1,1
2783,LECA,3,0,0,0,3,0,0
2784,LECA,2,0,0,1,1,1,0
2787,LECA,2,0,1,1,0,2,0
279,Chordata,17,0,1,2,14,3,0
2791,Opisthokonta,2,0,0,0,2,0,0
2792,Chordata,2,0,0,0,2,0,0
2794,LECA,5,1,0,0,4,1,0
2797,Bilateria,3,2,0,0,1,2,0
2798,LECA,3,1,0,0,2,1,0
28,LECA,10,4,0,0,6,4,0
2800,Gnathostomata,2,0,0,1,1,1,0
2803,LECA,3,0,0,1,2,1,0
2806,Bilateria,5,0,0,1,4,1,0
2809,Bilateria,3,1,1,0,1,2,0
281,Opisthokonta,7,1,1,0,5,2,0
2810,Bilateria,3,0,0,0,3,0,0
2813,Bilateria,2,0,0,0,2,0,0
2814,LECA,4,0,0,0,4,0,0
2816,Bilateria,5,0,2,0,3,2,0
2817,LECA,5,1,0,0,4,1,0
2818,LECA,4,0,0,0,4,0,0
2819,LECA,7,1,1,1,4,3,0
282,Gnathostomata,2,0,0,1,1,1,0
2822,LECA,3,0,1,0,2,1,0
2823,LECA,4,0,1,0,3,1,0
2825,LECA,3,1,0,0,2,1,0
2828,Opisthokonta,2,0,1,0,1,1,0
2829,LECA,5,1,2,0,2,3,0
2830,Vertebrata,2,0,0,0,2,0,0
2831,Opisthokonta,7,2,1,0,4,3,0
2836,Bilateria,2,0,0,0,2,0,0
284,LECA,3,1,0,1,1,2,0
285,LECA,6,0,2,1,3,3,0
2851,LECA,2,0,0,1,1,1,0
2854,LECA,2,0,0,0,2,0,0
2856,LECA,2,0,0,0,2,0,0
287,Vertebrata,4,0,0,0,4,0,0
2871,LECA,3,0,1,0,2,1,0
2872,LECA,2,0,1,0,1,1,0
2873,Chordata,2,0,0,0,2,0,0
288,LECA,4,0,2,0,2,2,0
289,Chordata,2,1,0,0,1,1,0
2893,LECA,2,0,0,1,1,1,0
29,Bilateria,17,7,2,3,5,12,0
290,Vertebrata,4,0,1,1,2,2,1
2907,LECA,3,0,0,1,2,1,0
291,LECA,14,2,1,3,8,6,0
2910,LECA,2,1,0,0,1,1,0
2912,Vertebrata,2,0,1,0,1,1,0
292,Vertebrata,3,0,0,0,3,0,0
2920,Vertebrata,3,2,0,1,0,3,0
2930,Bilateria,3,1,1,1,0,3,0
2931,LECA,7,2,1,2,2,5,0
2933,LECA,2,0,0,0,2,0,0
2936,LECA,2,0,0,0,2,0,0
294,Opisthokonta,3,1,1,0,1,2,0
2941,Vertebrata,2,1,0,0,1,1,0
2942,LECA,3,0,0,0,3,0,0
2943,Gnathostomata,2,0,0,0,2,0,0
2946,Gnathostomata,2,0,0,0,2,0,0
2947,LECA,3,1,1,0,1,2,0
295,LECA,19,2,2,3,12,7,1
2953,Gnathostomata,2,0,0,0,2,0,1
2954,Gnathostomata,2,0,0,1,1,1,0
2955,LECA,17,2,1,2,12,5,1
2957,LECA,3,0,0,0,3,0,0
2959,Catarrhini,2,0,1,0,1,1,0
296,LECA,5,0,0,0,5,0,0
2963,Gnathostomata,5,0,0,3,2,3,1
2964,Bilateria,2,1,0,0,1,1,0
2975,Vertebrata,2,0,0,0,2,0,0
2978,LECA,7,1,1,2,3,4,0
2981,LECA,3,1,0,0,2,1,0
2986,Vertebrata,3,0,1,0,2,1,0
2990,Chordata,2,0,1,0,1,1,0
2991,LECA,9,1,1,0,7,2,0
2992,LECA,7,0,1,0,6,1,0
3,Opisthokonta,2,0,1,0,1,1,0
300,LECA,6,0,0,0,6,0,0
3003,Gnathostomata,3,0,1,0,2,1,0
3009,Vertebrata,2,0,0,1,1,1,0
301,Bilateria,2,0,0,0,2,0,0
3014,Bilateria,2,0,0,0,2,0,0
3019,LECA,3,0,1,1,1,2,0
302,LECA,6,0,1,0,5,1,0
3026,Opisthokonta,2,0,0,0,2,0,0
3027,LECA,2,1,0,0,1,1,0
303,LECA,2,1,0,0,1,1,0
3036,LECA,2,0,1,0,1,1,0
304,Bilateria,3,0,0,0,3,0,0
3040,LECA,2,0,1,0,1,1,0
3041,Chordata,4,1,0,0,3,1,0
3045,LECA,4,0,1,1,2,2,1
305,LECA,2,0,0,1,1,1,0
3052,LECA,2,1,0,0,1,1,0
3054,LECA,3,2,0,0,1,2,0
3057,Gnathostomata,2,1,0,0,1,1,0
3059,LECA,4,1,1,1,1,3,1
306,LECA,7,2,0,0,5,2,0
3064,Eutheria,2,0,0,0,2,0,0
3067,LECA,2,1,0,1,0,2,0
3069,LECA,2,0,0,1,1,1,1
307,LECA,5,0,1,0,4,1,0
3071,Gnathostomata,3,0,0,0,3,0,0
3074,LECA,2,0,1,0,1,1,0
3077,Bilateria,2,0,0,1,1,1,0
308,LECA,9,0,1,0,8,1,0
3082,LECA,6,0,0,1,5,1,0
3083,LECA,2,0,0,0,2,0,0
3087,LECA,5,0,1,1,3,2,0
309,Chordata,4,0,0,0,4,0,0
3090,Vertebrata,2,0,1,0,1,1,0
3091,LECA,2,0,0,1,1,1,0
3096,Vertebrata,3,0,0,0,3,0,0
3099,Opisthokonta,5,0,0,2,3,2,0
31,Bilateria,11,2,2,1,6,5,1
310,Bilateria,3,1,1,0,1,2,0
3105,Chordata,4,0,0,1,3,1,0
311,Bilateria,2,0,0,1,1,1,0
3110,Bilateria,2,0,0,0,2,0,0
3118,LECA,2,0,0,0,2,0,0
3119,LECA,6,0,1,0,5,1,0
312,Vertebrata,12,2,2,1,7,5,1
3121,Simiiformes,6,0,0,2,4,2,0
3122,LECA,8,4,1,0,3,5,0
3124,LECA,3,0,1,1,1,2,0
3128,LECA,2,1,0,0,1,1,0
3129,Gnathostomata,3,0,0,2,1,2,0
313,Chordata,2,0,0,0,2,0,0
3131,Gnathostomata,2,0,0,0,2,0,0
3136,LECA,3,0,1,2,0,3,1
3138,LECA,3,1,1,0,1,2,1
3143,Bilateria,2,0,0,1,1,1,0
3146,Tetrapoda,4,0,0,1,3,1,0
3148,LECA,3,1,0,0,2,1,0
315,LECA,2,0,1,0,1,1,0
316,LECA,21,1,4,7,9,12,4
3160,LECA,2,0,0,0,2,0,0
3161,Gnathostomata,5,0,1,0,4,1,0
3164,LECA,2,0,0,0,2,0,0
3166,LECA,3,0,2,0,1,2,0
3169,LECA,3,0,0,0,3,0,0
317,Vertebrata,3,0,0,0,3,0,1
3172,LECA,3,0,1,0,2,1,1
3174,LECA,5,0,0,0,5,0,0
3176,Chordata,2,0,1,0,1,1,1
318,LECA,11,1,2,1,7,4,0
3184,LECA,3,0,1,0,2,1,0
3186,Opisthokonta,6,1,0,1,4,2,0
3187,Opisthokonta,2,2,0,0,0,2,0
319,LECA,14,4,1,2,7,7,0
3194,Opisthokonta,2,0,0,1,1,1,0
3197,Gnathostomata,2,1,0,0,1,1,0
32,LECA,3,1,0,0,2,1,0
320,LECA,34,2,5,3,24,10,0
3204,Vertebrata,2,0,0,0,2,0,0
3211,Vertebrata,2,0,0,0,2,0,0
3212,Bilateria,2,0,1,1,0,2,1
3216,LECA,2,1,0,1,0,2,0
3219,LECA,3,0,1,0,2,1,0
322,LECA,2,0,0,0,2,0,0
3221,Opisthokonta,2,0,1,0,1,1,0
3224,LECA,3,1,0,0,2,1,1
3225,LECA,2,1,0,0,1,1,0
3227,Vertebrata,2,0,0,0,2,0,0
3228,LECA,3,0,1,0,2,1,0
323,Opisthokonta,3,0,0,0,3,0,0
3234,Vertebrata,4,2,1,0,1,3,0
3235,Vertebrata,2,0,1,0,1,1,0
3236,LECA,2,0,0,0,2,0,0
3239,Chordata,4,1,1,0,2,2,0
3243,LECA,2,0,0,0,2,0,0
325,LECA,52,5,2,4,41,11,1
3250,LECA,2,0,0,0,2,0,0
3255,LECA,3,1,0,2,0,3,0
3256,Vertebrata,4,0,0,0,4,0,0
3257,LECA,5,0,0,1,4,1,0
326,Chordata,12,1,0,3,8,4,0
3264,Chordata,4,0,0,1,3,1,0
3265,Chordata,3,0,1,1,1,2,1
3267,LECA,3,1,1,1,0,3,1
327,Bilateria,7,0,2,0,5,2,0
3274,Gnathostomata,2,1,0,0,1,1,0
3276,Vertebrata,2,1,0,0,1,1,0
328,LECA,4,0,0,0,4,0,0
329,LECA,3,0,1,0,2,1,0
3291,LECA,2,0,0,1,1,1,0
3292,Bilateria,24,1,4,0,19,5,0
3295,Vertebrata,3,0,1,2,0,3,1
3296,LECA,2,0,1,0,1,1,0
3299,Vertebrata,2,1,0,1,0,2,1
33,LECA,14,2,4,1,7,7,0
3301,Vertebrata,2,0,0,0,2,0,0
3309,LECA,2,0,0,2,0,2,0
3313,Bilateria,2,1,0,1,0,2,0
3314,LECA,2,0,0,0,2,0,0
3316,LECA,2,0,0,1,1,1,0
3318,LECA,5,1,2,2,0,5,2
3320,LECA,3,2,0,0,1,2,0
3321,LECA,3,1,0,0,2,1,0
3325,Bilateria,4,1,0,0,3,1,0
3327,Vertebrata,3,0,1,1,1,2,0
3329,LECA,3,0,1,0,2,1,0
333,LECA,7,1,1,1,4,3,0
3334,LECA,2,0,0,0,2,0,1
3336,LECA,2,0,0,0,2,0,0
3340,LECA,2,0,1,0,1,1,0
3342,Gnathostomata,2,0,1,0,1,1,0
335,LECA,2,0,1,0,1,1,0
3351,LECA,3,0,1,0,2,1,0
3352,Gnathostomata,2,0,0,0,2,0,0
3356,Bilateria,11,0,2,0,9,2,0
336,Opisthokonta,2,0,0,0,2,0,0
3364,Bilateria,3,1,0,0,2,1,0
3365,LECA,8,1,1,0,6,2,0
337,Bilateria,3,1,1,0,1,2,0
338,Gnathostomata,2,1,0,1,0,2,0
3381,Vertebrata,2,0,0,0,2,0,0
3384,Opisthokonta,5,1,0,1,3,2,0
3385,LECA,5,0,0,0,5,0,0
339,LECA,32,2,7,6,17,15,1
3393,LECA,2,1,0,0,1,1,0
34,Opisthokonta,12,2,2,0,8,4,1
340,LECA,3,0,0,0,3,0,0
3402,Opisthokonta,3,1,0,2,0,3,0
3403,Bilateria,2,2,0,0,0,2,1
3412,LECA,3,0,0,0,3,0,0
3413,LECA,2,0,0,0,2,0,1
3418,Bilateria,9,1,0,1,7,2,0
342,LECA,9,1,2,0,6,3,0
343,LECA,32,4,4,6,18,14,1
3430,LECA,12,0,3,3,6,6,2
3431,LECA,3,0,1,0,2,1,0
3435,Bilateria,2,0,0,1,1,1,0
3437,Bilateria,15,0,4,3,8,7,1
3442,LECA,3,0,1,1,1,2,1
3448,LECA,4,0,0,1,3,1,0
3459,Opisthokonta,2,0,0,1,1,1,0
346,Opisthokonta,3,1,0,0,2,1,0
3466,LECA,6,1,2,0,3,3,0
3467,LECA,2,0,2,0,0,2,0
3471,Vertebrata,3,1,1,0,1,2,0
348,LECA,19,1,3,3,12,7,1
3480,LECA,9,0,3,1,5,4,0
3481,LECA,4,0,2,0,2,2,1
3482,Opisthokonta,3,0,0,1,2,1,0
3483,Bilateria,8,1,1,0,6,2,1
3486,LECA,2,0,0,0,2,0,0
3487,LECA,2,0,0,0,2,0,0
3489,LECA,2,0,0,0,2,0,0
3491,LECA,2,1,0,0,1,1,0
3492,LECA,4,0,1,1,2,2,0
35,LECA,28,4,3,7,14,14,0
350,LECA,18,2,1,3,12,6,1
3508,Bilateria,4,0,1,0,3,1,0
3509,LECA,7,0,1,0,6,1,0
351,Chordata,3,0,0,2,1,2,0
3510,Bilateria,2,0,1,0,1,1,0
3514,LECA,13,1,2,2,8,5,0
352,LECA,16,4,2,0,10,6,0
3527,LECA,3,0,2,0,1,2,0
3528,LECA,6,0,0,3,3,3,0
3529,Gnathostomata,2,0,1,0,1,1,0
353,LECA,4,1,0,0,3,1,0
3533,Opisthokonta,4,0,0,1,3,1,1
3537,Gnathostomata,2,1,0,0,1,1,1
3539,LECA,4,1,2,0,1,3,0
354,LECA,4,1,1,1,1,3,0
3540,LECA,3,0,0,0,3,0,0
3546,LECA,2,1,0,0,1,1,0
355,LECA,3,1,0,1,1,2,0
3551,LECA,8,2,1,0,5,3,0
3556,Bilateria,4,0,0,1,3,1,0
3557,Bilateria,4,0,0,0,4,0,0
356,LECA,14,0,3,2,9,5,0
3565,Gnathostomata,2,0,0,0,2,0,0
3566,LECA,2,0,0,0,2,0,0
3569,Bilateria,4,1,1,1,1,3,0
357,LECA,5,1,0,1,3,2,0
3571,Chordata,7,1,1,2,3,4,0
3572,Vertebrata,2,1,0,0,1,1,0
3575,Chordata,6,2,0,0,4,2,0
3579,LECA,2,0,0,1,1,1,0
358,LECA,9,1,1,2,5,4,2
3580,LECA,12,0,0,0,12,0,0
3582,Vertebrata,4,1,1,0,2,2,0
3585,LECA,5,0,0,0,5,0,0
3586,LECA,2,0,0,1,1,1,0
3588,Bilateria,6,0,2,1,3,3,1
359,Gnathostomata,4,1,0,1,2,2,0
3591,Bilateria,4,0,0,0,4,0,0
3597,LECA,5,2,1,0,2,3,1
36,LECA,2,0,0,0,2,0,0
360,LECA,2,0,0,0,2,0,0
3606,LECA,3,2,0,0,1,2,0
3609,LECA,3,0,0,1,2,1,0
3611,LECA,3,0,0,0,3,0,0
3615,LECA,2,0,0,0,2,0,1
3616,Bilateria,4,1,0,0,3,1,1
3618,Vertebrata,3,0,0,1,2,1,0
362,LECA,2,1,0,0,1,1,0
3627,LECA,3,0,3,0,0,3,0
363,LECA,2,0,0,0,2,0,0
3630,Bilateria,4,1,0,1,2,2,0
3634,Opisthokonta,3,0,0,0,3,0,0
3638,Opisthokonta,3,0,0,1,2,1,0
364,Bilateria,3,0,1,1,1,2,1
3640,LECA,3,0,0,0,3,0,0
3642,Vertebrata,2,1,1,0,0,2,0
3645,Bilateria,3,0,0,1,2,1,0
3648,LECA,3,0,0,1,2,1,0
3654,LECA,2,0,0,1,1,1,0
3655,LECA,2,0,0,2,0,2,1
3656,Chordata,3,0,1,0,2,1,0
3657,Vertebrata,2,0,0,0,2,0,0
366,LECA,3,2,0,0,1,2,0
3662,LECA,7,0,0,0,7,0,0
3663,LECA,5,3,0,0,2,3,0
367,Gnathostomata,2,0,0,0,2,0,0
3672,LECA,2,0,0,1,1,1,0
3674,Bilateria,2,0,0,1,1,1,0
3679,LECA,3,1,0,0,2,1,0
368,LECA,4,0,2,0,2,2,0
3687,LECA,3,0,0,1,2,1,0
369,LECA,6,0,0,1,5,1,0
3695,Simiiformes,2,0,0,0,2,0,0
37,LECA,9,0,2,1,6,3,0
370,Bilateria,2,0,1,0,1,1,0
3700,Vertebrata,6,1,0,0,5,1,0
3702,LECA,2,0,0,2,0,2,1
3703,LECA,2,0,1,0,1,1,0
3706,Vertebrata,2,0,1,0,1,1,0
3708,Bilateria,2,0,0,2,0,2,1
3709,LECA,2,0,0,0,2,0,0
371,LECA,25,3,0,3,19,6,3
3714,Vertebrata,8,0,0,0,8,0,0
3718,Bilateria,2,0,0,1,1,1,0
3720,Opisthokonta,4,2,0,2,0,4,2
3721,LECA,2,0,2,0,0,2,0
3733,Vertebrata,2,0,0,0,2,0,1
3735,Vertebrata,2,0,0,1,1,1,0
3736,LECA,4,1,0,1,2,2,0
3737,Opisthokonta,2,0,0,1,1,1,1
3739,Bilateria,2,0,0,0,2,0,0
374,LECA,7,0,0,4,3,4,0
3740,Bilateria,2,0,0,1,1,1,2
3746,Opisthokonta,5,0,1,0,4,1,1
3748,Chordata,3,0,0,0,3,0,0
3751,LECA,2,2,0,0,0,2,1
3752,LECA,2,0,0,0,2,0,0
3763,Tetrapoda,5,1,0,1,3,2,0
3764,Gnathostomata,2,0,0,0,2,0,0
3765,LECA,2,0,0,0,2,0,0
3767,LECA,3,0,0,1,2,1,0
377,Chordata,22,3,3,1,15,7,0
3774,Opisthokonta,2,0,0,1,1,1,0
3775,LECA,9,0,1,0,8,1,0
3778,LECA,2,0,0,0,2,0,0
3782,Opisthokonta,2,0,0,1,1,1,0
3787,LECA,2,0,0,2,0,2,0
379,LECA,2,0,0,0,2,0,0
3792,Vertebrata,4,0,0,1,3,1,0
3794,LECA,2,1,0,1,0,2,0
3799,Opisthokonta,5,0,1,1,3,2,1
38,LECA,9,1,0,0,8,1,1
380,LECA,30,2,2,1,25,5,0
3803,LECA,3,0,0,0,3,0,0
3807,LECA,2,1,0,0,1,1,0
3809,LECA,3,0,0,1,2,1,1
381,LECA,5,0,0,1,4,1,0
3818,Chordata,9,2,0,2,5,4,0
382,Gnathostomata,9,2,0,2,5,4,2
3822,Bilateria,3,0,0,0,3,0,0
383,LECA,13,1,1,1,10,3,0
3834,LECA,3,1,0,0,2,1,0
384,LECA,3,0,0,0,3,0,0
3840,LECA,3,2,0,0,1,2,0
3845,LECA,5,0,0,2,3,2,0
3847,LECA,2,0,0,1,1,1,0
385,LECA,10,1,0,2,7,3,0
386,LECA,54,5,3,8,38,16,4
3860,LECA,6,1,1,0,4,2,0
3871,LECA,4,0,0,0,4,0,0
3872,Euteleostomi,4,1,0,0,3,1,0
388,Bilateria,7,1,0,1,5,2,0
3880,Vertebrata,2,0,0,0,2,0,0
3881,Bilateria,3,0,0,1,2,1,0
389,LECA,3,1,0,0,2,1,0
3892,LECA,15,1,1,0,13,2,0
3894,Opisthokonta,3,0,1,0,2,1,0
3897,Gnathostomata,3,0,1,0,2,1,0
3899,LECA,2,1,0,0,1,1,0
39,Euteleostomi,2,0,0,1,1,1,0
390,LECA,13,1,1,0,11,2,0
3902,LECA,5,1,0,1,3,2,0
3906,Hominidae,3,0,0,0,3,0,0
3907,LECA,2,0,1,0,1,1,0
3908,Chordata,2,0,0,0,2,0,0
3917,Vertebrata,2,0,0,1,1,1,1
392,LECA,13,2,3,2,6,7,0
3926,LECA,2,0,0,0,2,0,0
393,LECA,3,1,0,0,2,1,0
3930,LECA,15,0,0,3,12,3,0
3937,Opisthokonta,2,0,0,2,0,2,1
3940,Vertebrata,3,0,0,2,1,2,0
3942,LECA,3,1,0,0,2,1,0
3943,LECA,4,0,0,0,4,0,0
3945,LECA,5,0,0,1,4,1,0
3947,LECA,2,0,0,0,2,0,0
395,LECA,3,0,0,0,3,0,0
3952,Opisthokonta,2,2,0,0,0,2,0
3954,Euteleostomi,3,1,0,1,1,2,0
3957,Vertebrata,2,0,0,0,2,0,0
3958,Bilateria,6,1,1,0,4,2,1
3959,Gnathostomata,5,0,0,2,3,2,1
396,Bilateria,7,1,1,0,5,2,1
3963,Bilateria,4,0,0,0,4,0,0
397,Gnathostomata,3,0,0,1,2,1,0
3977,LECA,2,0,0,0,2,0,0
398,Bilateria,4,0,1,0,3,1,0
3981,LECA,2,0,1,0,1,1,0
3982,LECA,3,0,0,0,3,0,0
3983,Vertebrata,2,0,0,0,2,0,0
3987,Amniota,2,0,0,1,1,1,0
399,LECA,3,0,0,0,3,0,0
3990,Gnathostomata,2,0,1,0,1,1,0
3992,LECA,4,0,0,0,4,0,0
3994,LECA,5,1,1,0,3,2,0
4,LECA,3,0,2,0,1,2,0
40,LECA,17,4,1,2,10,7,0
400,LECA,2,0,0,0,2,0,0
4000,Bilateria,4,0,1,0,3,1,0
4002,LECA,2,0,0,0,2,0,0
4005,Chordata,3,0,0,0,3,0,0
4007,LECA,2,0,0,0,2,0,0
4008,LECA,3,2,0,1,0,3,0
401,LECA,19,4,0,3,12,7,1
4013,Chordata,2,0,0,0,2,0,0
4019,LECA,4,0,2,1,1,3,0
402,Bilateria,8,2,1,2,3,5,0
4020,LECA,2,0,2,0,0,2,0
4022,Bilateria,2,2,0,0,0,2,0
4027,Amniota,15,0,2,1,12,3,0
4032,LECA,3,1,0,0,2,1,0
404,LECA,11,1,4,0,6,5,0
4043,Opisthokonta,2,0,0,0,2,0,0
4044,Vertebrata,9,0,0,1,8,1,0
405,LECA,3,1,0,0,2,1,0
4050,LECA,2,0,1,0,1,1,0
4051,Vertebrata,4,0,0,1,3,1,1
4054,Bilateria,2,0,0,0,2,0,0
4056,Gnathostomata,2,1,0,0,1,1,0
4057,Opisthokonta,2,0,0,0,2,0,0
4059,LECA,2,0,1,0,1,1,0
4063,Opisthokonta,2,0,1,0,1,1,0
407,Opisthokonta,2,0,0,0,2,0,0
4070,LECA,2,0,0,0,2,0,0
4071,Gnathostomata,3,0,1,0,2,1,0
4072,LECA,2,0,1,0,1,1,0
4073,Gnathostomata,2,1,0,0,1,1,0
4076,LECA,4,0,2,1,1,3,1
4077,LECA,2,0,0,0,2,0,0
4084,Vertebrata,2,1,0,0,1,1,0
409,LECA,4,0,1,0,3,1,0
4097,Euteleostomi,2,1,0,0,1,1,0
41,LECA,7,3,0,0,4,3,0
410,Opisthokonta,2,0,0,0,2,0,0
411,LECA,12,0,0,0,12,0,0
4110,LECA,4,1,0,1,2,2,0
4113,LECA,7,3,0,0,4,3,0
4119,Gnathostomata,2,0,0,0,2,0,0
4121,Euteleostomi,4,0,1,0,3,1,0
4122,Chordata,2,0,1,0,1,1,0
4129,Gnathostomata,2,0,0,0,2,0,0
413,LECA,3,1,1,0,1,2,0
414,LECA,8,1,1,0,6,2,0
4142,LECA,2,0,0,0,2,0,0
4143,Eutheria,2,0,0,0,2,0,0
4149,Chordata,17,2,2,0,13,4,2
415,LECA,28,5,2,2,19,9,0
416,LECA,10,1,1,2,6,4,1
4163,Vertebrata,2,0,0,0,2,0,0
4169,LECA,19,3,6,1,9,10,1
418,LECA,4,0,0,0,4,0,0
4183,Vertebrata,3,0,0,0,3,0,0
419,LECA,6,2,1,2,1,5,0
4196,LECA,2,0,0,0,2,0,0
4200,LECA,2,1,0,0,1,1,0
4207,LECA,2,0,1,0,1,1,0
4211,LECA,3,1,1,0,1,2,0
4221,Gnathostomata,4,1,0,0,3,1,0
4223,Vertebrata,2,0,0,0,2,0,0
4227,Gnathostomata,2,0,0,0,2,0,0
4229,LECA,2,1,0,0,1,1,0
423,LECA,13,0,0,1,12,1,0
4231,Vertebrata,3,1,1,0,1,2,0
4236,Bilateria,2,0,0,2,0,2,0
4237,LECA,2,0,0,0,2,0,0
4244,LECA,2,1,0,0,1,1,0
4246,Bilateria,4,0,1,0,3,1,0
4248,Bilateria,13,1,0,1,11,2,0
425,LECA,7,1,0,1,5,2,1
4250,Bilateria,5,1,2,0,2,3,0
4252,LECA,3,0,0,1,2,1,1
4256,LECA,3,0,0,2,1,2,0
426,LECA,7,2,1,0,4,3,0
4263,Bilateria,3,2,0,0,1,2,0
4264,LECA,3,0,0,1,2,1,0
427,Bilateria,5,1,0,1,3,2,1
4274,LECA,3,1,0,0,2,1,0
4277,LECA,2,1,0,0,1,1,0
4280,Gnathostomata,2,0,0,0,2,0,0
4287,Vertebrata,2,0,0,0,2,0,0
4288,LECA,3,1,0,0,2,1,0
429,LECA,5,0,1,0,4,1,0
43,LECA,22,2,5,1,14,8,1
430,LECA,8,2,1,0,5,3,0
431,LECA,2,0,1,0,1,1,0
4317,LECA,2,0,0,0,2,0,0
432,Gnathostomata,2,0,0,0,2,0,0
4328,Vertebrata,2,1,0,0,1,1,1
433,Bilateria,4,0,0,1,3,1,0
4338,LECA,3,0,1,0,2,1,0
434,LECA,8,0,0,1,7,1,1
4345,Gnathostomata,2,0,0,0,2,0,0
4347,LECA,2,0,0,0,2,0,0
435,Bilateria,11,3,2,0,6,5,1
4351,Opisthokonta,2,0,0,0,2,0,0
4352,Bilateria,6,1,1,0,4,2,0
4354,LECA,2,0,0,0,2,0,0
4357,Opisthokonta,4,0,0,0,4,0,0
4364,Simiiformes,2,0,0,0,2,0,0
437,Opisthokonta,3,0,0,0,3,0,0
4373,Bilateria,2,0,0,0,2,0,0
438,LECA,52,4,9,3,36,16,1
4381,Vertebrata,2,0,0,0,2,0,0
4387,LECA,2,0,1,1,0,2,0
439,Chordata,4,1,0,0,3,1,0
4390,Bilateria,2,1,1,0,0,2,0
4393,Gnathostomata,2,1,0,0,1,1,0
44,LECA,5,0,0,0,5,0,0
440,LECA,22,1,2,1,18,4,1
4404,LECA,2,1,0,0,1,1,0
4405,Vertebrata,2,0,0,0,2,0,0
441,LECA,2,0,0,2,0,2,0
4412,Amniota,2,0,0,0,2,0,0
443,LECA,3,1,2,0,0,3,0
4431,Bilateria,9,0,1,6,2,7,0
4432,LECA,6,1,0,3,2,4,0
4433,Vertebrata,2,0,1,1,0,2,0
444,LECA,11,0,2,2,7,4,0
4441,Euteleostomi,11,3,0,1,7,4,0
4443,Opisthokonta,3,0,1,0,2,1,0
4451,Opisthokonta,2,1,0,1,0,2,0
4458,Vertebrata,2,0,1,0,1,1,0
4459,LECA,4,0,0,0,4,0,0
446,LECA,4,1,0,2,1,3,0
4464,Vertebrata,2,1,0,0,1,1,0
4471,Simiiformes,3,1,0,0,2,1,0
4479,Chordata,2,0,0,0,2,0,0
448,LECA,3,0,0,0,3,0,0
4482,LECA,4,0,1,0,3,1,0
449,Vertebrata,2,0,0,0,2,0,0
4493,Gnathostomata,2,0,0,0,2,0,1
4494,LECA,2,0,0,0,2,0,0
4499,Chordata,2,0,1,0,1,1,0
45,Bilateria,9,0,0,2,7,2,1
450,Chordata,3,0,0,0,3,0,0
4509,LECA,3,0,1,2,0,3,0
4519,Bilateria,3,0,1,0,2,1,0
452,LECA,22,3,4,1,14,8,0
4523,Euteleostomi,8,0,1,3,4,4,1
4526,LECA,2,0,0,0,2,0,0
4528,LECA,2,0,0,0,2,0,0
453,LECA,6,0,1,1,4,2,2
4537,Vertebrata,3,0,0,0,3,0,0
4543,Bilateria,6,1,0,1,4,2,0
4547,Euteleostomi,2,0,0,0,2,0,0
455,LECA,29,2,5,2,20,9,2
4555,LECA,13,4,3,0,6,7,3
4557,LECA,2,0,1,0,1,1,0
456,LECA,8,0,2,0,6,2,0
4563,LECA,2,0,0,2,0,2,0
4564,Gnathostomata,2,0,0,0,2,0,0
4570,Bilateria,4,0,0,1,3,1,0
4572,Vertebrata,3,0,1,0,2,1,0
4575,LECA,4,0,1,1,2,2,0
4577,LECA,6,2,0,0,4,2,0
4580,Gnathostomata,2,0,0,0,2,0,0
4581,Chordata,3,0,0,0,3,0,0
4585,Gnathostomata,3,1,1,0,1,2,0
4588,LECA,3,0,0,0,3,0,0
459,LECA,2,0,0,0,2,0,0
4595,LECA,2,0,0,0,2,0,0
46,LECA,4,0,1,1,2,2,0
4611,LECA,5,0,1,1,3,2,0
4620,Bilateria,4,1,0,1,2,2,0
4624,LECA,2,0,0,0,2,0,0
4639,Haplorrhini,3,1,0,0,2,1,1
464,LECA,3,0,0,0,3,0,1
4643,LECA,2,0,0,0,2,0,0
4647,LECA,2,0,0,0,2,0,0
4649,Vertebrata,2,1,0,0,1,1,0
465,LECA,14,1,1,5,7,7,1
4651,Catarrhini,6,0,0,0,6,0,1
4653,LECA,2,1,0,0,1,1,0
466,Opisthokonta,2,0,0,1,1,1,0
4660,Opisthokonta,2,0,1,0,1,1,0
4661,Opisthokonta,2,0,1,0,1,1,0
4668,LECA,2,0,0,0,2,0,0
4669,Gnathostomata,2,0,0,0,2,0,0
4671,Eutheria,3,0,0,0,3,0,0
4677,Gnathostomata,2,0,0,0,2,0,0
4678,Vertebrata,4,1,0,0,3,1,0
4679,Opisthokonta,2,0,0,0,2,0,0
468,Gnathostomata,2,0,0,0,2,0,0
4680,LECA,4,0,0,0,4,0,1
4699,Opisthokonta,2,1,0,0,1,1,0
47,LECA,2,0,1,0,1,1,0
470,LECA,2,0,0,1,1,1,0
4708,Bilateria,3,1,0,0,2,1,0
471,LECA,66,7,8,6,45,21,3
4712,LECA,2,0,0,1,1,1,0
4729,LECA,2,1,0,0,1,1,0
4736,Vertebrata,3,1,0,1,1,2,0
4737,LECA,3,0,0,1,2,1,0
474,LECA,7,0,0,0,7,0,0
4740,LECA,2,0,1,1,0,2,0
4741,Bilateria,11,1,3,0,7,4,0
4743,Chordata,2,2,0,0,0,2,0
475,LECA,3,0,0,1,2,1,0
4755,Opisthokonta,3,0,0,1,2,1,1
4756,Euteleostomi,2,1,0,0,1,1,0
476,LECA,24,5,5,2,12,12,0
4760,Euteleostomi,2,0,0,0,2,0,0
4761,Hominoidea,2,0,1,0,1,1,0
4762,LECA,2,0,0,0,2,0,0
4763,Gnathostomata,2,0,1,0,1,1,0
4765,Chordata,3,0,1,0,2,1,0
477,Bilateria,7,1,0,0,6,1,0
4770,Vertebrata,4,0,0,0,4,0,0
4771,Gnathostomata,2,0,0,1,1,1,0
4774,LECA,5,1,0,1,3,2,0
4777,Vertebrata,2,0,0,2,0,2,1
4779,Euteleostomi,2,1,0,1,0,2,0
4783,Gnathostomata,2,0,1,0,1,1,0
4788,LECA,2,1,0,0,1,1,0
479,Vertebrata,3,0,1,0,2,1,0
4795,LECA,2,0,0,0,2,0,0
4797,Bilateria,5,1,2,0,2,3,1
4798,Gnathostomata,2,0,1,0,1,1,0
48,LECA,5,1,0,2,2,3,0
481,Bilateria,3,1,0,0,2,1,0
4810,LECA,2,0,0,2,0,2,0
4814,Bilateria,4,0,0,0,4,0,0
4817,Opisthokonta,7,0,1,1,5,2,1
4826,Vertebrata,3,0,1,0,2,1,0
483,LECA,7,0,0,3,4,3,0
4831,LECA,6,0,0,0,6,0,0
4837,LECA,2,0,1,0,1,1,0
4839,LECA,2,0,1,0,1,1,0
484,LECA,26,6,1,5,14,12,1
4840,Opisthokonta,2,1,0,0,1,1,0
4847,LECA,2,1,0,0,1,1,0
4849,Chordata,2,0,0,0,2,0,0
485,Gnathostomata,2,0,0,1,1,1,0
4851,LECA,2,0,1,1,0,2,0
4855,Bilateria,4,1,0,0,3,1,0
4856,LECA,3,1,0,1,1,2,0
486,LECA,13,1,1,1,10,3,0
4861,LECA,2,1,0,0,1,1,0
4877,Gnathostomata,3,0,0,0,3,0,0
488,LECA,4,0,0,0,4,0,1
4882,Opisthokonta,2,0,0,1,1,1,0
4887,LECA,3,0,2,0,1,2,0
489,LECA,5,2,1,0,2,3,0
4893,LECA,3,0,0,0,3,0,0
4894,Bilateria,7,0,2,1,4,3,1
4895,Euteleostomi,10,0,0,0,10,0,0
49,LECA,18,3,3,1,11,7,0
490,LECA,9,1,0,1,7,2,0
491,LECA,14,2,2,3,7,7,0
4910,Euteleostomi,2,0,0,0,2,0,0
4912,LECA,3,0,0,2,1,2,0
4919,Vertebrata,2,1,0,0,1,1,0
492,LECA,3,2,0,0,1,2,0
4925,Gnathostomata,3,0,0,1,2,1,0
4928,LECA,3,0,1,0,2,1,0
493,Bilateria,12,0,1,0,11,1,2
4931,Chordata,2,0,0,0,2,0,0
4932,LECA,2,1,0,0,1,1,0
4933,Vertebrata,3,1,0,0,2,1,0
4936,LECA,2,0,1,0,1,1,0
4938,Vertebrata,2,0,0,0,2,0,0
494,Amniota,2,0,1,0,1,1,0
4948,Gnathostomata,2,0,1,0,1,1,0
495,Eutheria,2,0,0,0,2,0,0
4952,Bilateria,3,0,1,0,2,1,0
4953,Bilateria,2,0,0,0,2,0,0
4955,Bilateria,3,2,0,0,1,2,0
4960,Opisthokonta,2,0,0,0,2,0,0
4963,LECA,2,0,0,0,2,0,0
4965,Opisthokonta,2,0,0,1,1,1,0
497,Bilateria,3,0,0,0,3,0,0
4970,Sarcopterygii,3,0,1,0,2,1,0
4972,LECA,3,1,1,0,1,2,0
4973,LECA,6,1,0,0,5,1,0
4978,Gnathostomata,2,1,1,0,0,2,0
4980,Bilateria,3,1,1,0,1,2,0
4982,Bilateria,3,0,0,2,1,2,1
4983,Vertebrata,3,0,0,0,3,0,0
4986,Bilateria,3,0,0,1,2,1,0
499,LECA,13,1,1,7,4,9,2
4991,Bilateria,3,0,0,1,2,1,1
5,LECA,33,3,8,7,15,18,3
50,LECA,3,1,0,0,2,1,0
500,LECA,7,1,5,0,1,6,0
5009,Gnathostomata,3,0,0,0,3,0,0
501,Vertebrata,3,0,1,0,2,1,0
5016,LECA,2,0,1,1,0,2,1
502,LECA,32,3,4,4,21,11,2
503,LECA,4,0,1,1,2,2,0
5032,Bilateria,3,0,1,1,1,2,0
5034,Vertebrata,2,1,0,1,0,2,0
5039,Bilateria,3,0,1,1,1,2,0
504,LECA,2,0,0,0,2,0,0
5040,Opisthokonta,2,0,0,0,2,0,0
5041,Gnathostomata,2,0,0,0,2,0,0
506,Vertebrata,2,1,1,0,0,2,0
5060,Eutheria,3,0,0,0,3,0,0
5061,Vertebrata,2,1,1,0,0,2,0
5062,LECA,2,1,0,1,0,2,1
5071,Bilateria,4,0,0,1,3,1,0
5076,Vertebrata,2,1,0,0,1,1,0
5086,LECA,3,0,1,1,1,2,0
5087,Theria,2,0,0,0,2,0,0
5089,Theria,3,0,0,0,3,0,0
509,LECA,28,4,4,3,17,11,0
5096,Chordata,4,1,1,0,2,2,0
5098,Vertebrata,3,0,2,0,1,2,0
51,LECA,11,3,1,1,6,5,0
5100,Vertebrata,3,1,2,0,0,3,0
5104,LECA,3,1,0,0,2,1,0
5111,Bilateria,2,1,0,0,1,1,0
5115,Gnathostomata,2,0,1,0,1,1,0
5116,Chordata,3,0,0,0,3,0,0
512,Gnathostomata,3,0,0,1,2,1,0
5126,Opisthokonta,2,0,0,1,1,1,0
513,LECA,8,0,1,1,6,2,0
5132,Vertebrata,2,0,1,0,1,1,0
5133,LECA,2,0,0,0,2,0,0
5145,Bilateria,2,0,1,1,0,2,0
515,LECA,3,0,0,0,3,0,0
5151,LECA,4,0,1,0,3,1,0
5158,Gnathostomata,2,0,0,1,1,1,1
516,Gnathostomata,2,0,0,0,2,0,0
5161,Vertebrata,2,0,0,0,2,0,0
5166,LECA,3,0,0,0,3,0,0
5176,Gnathostomata,2,0,0,0,2,0,0
5179,Vertebrata,2,1,0,0,1,1,0
518,LECA,3,0,2,1,0,3,0
5190,Gnathostomata,2,1,0,0,1,1,0
52,LECA,39,4,3,5,27,12,2
5200,Chordata,2,0,1,0,1,1,0
5203,LECA,5,2,2,0,1,4,0
5215,Opisthokonta,2,0,0,0,2,0,0
5218,Chordata,2,0,0,0,2,0,1
522,LECA,11,1,2,3,5,6,2
5234,Vertebrata,2,0,0,0,2,0,0
5238,Gnathostomata,3,0,0,2,1,2,0
5239,LECA,3,2,1,0,0,3,0
524,Bilateria,2,0,1,0,1,1,0
5243,Gnathostomata,2,0,0,1,1,1,0
5248,Vertebrata,2,0,0,0,2,0,0
525,LECA,2,0,0,1,1,1,0
5250,LECA,2,0,0,1,1,1,1
5254,LECA,2,0,0,0,2,0,1
5256,Bilateria,2,1,0,0,1,1,0
5259,Theria,2,0,1,0,1,1,0
526,Amniota,2,0,0,0,2,0,0
5276,Bilateria,5,1,1,0,3,2,0
5283,LECA,3,0,0,0,3,0,0
5286,Sarcopterygii,2,0,0,0,2,0,0
5288,Bilateria,4,0,1,0,3,1,0
53,LECA,46,7,2,8,29,17,2
531,LECA,3,1,1,0,1,2,0
532,LECA,6,0,1,1,4,2,0
533,Vertebrata,3,0,1,0,2,1,0
5334,LECA,3,2,0,0,1,2,0
5335,LECA,2,0,0,0,2,0,0
5336,Eutheria,4,2,0,0,2,2,0
5339,Eutheria,9,2,1,2,4,5,0
534,Bilateria,3,0,0,1,2,1,0
5348,LECA,2,1,0,0,1,1,0
535,LECA,35,4,1,2,28,7,0
5350,LECA,3,1,0,0,2,1,0
5356,LECA,2,0,0,0,2,0,0
5358,LECA,6,0,0,0,6,0,0
536,LECA,10,2,1,1,6,4,1
537,LECA,20,2,1,1,16,4,1
5372,Vertebrata,4,0,0,1,3,1,0
5375,Chordata,2,1,0,0,1,1,0
538,LECA,2,0,1,0,1,1,0
539,LECA,11,2,2,4,3,8,0
5398,LECA,2,0,0,0,2,0,0
54,Gnathostomata,2,0,0,0,2,0,0
540,LECA,3,1,0,0,2,1,0
5413,Chordata,2,0,0,0,2,0,0
5414,Simiiformes,2,1,0,0,1,1,0
542,LECA,5,1,1,0,3,2,0
543,LECA,4,1,0,0,3,1,0
5437,Gnathostomata,6,0,2,1,3,3,0
544,Bilateria,5,1,0,2,2,3,1
5444,Vertebrata,4,1,1,1,1,3,0
5447,Gnathostomata,2,0,1,0,1,1,0
545,LECA,4,0,2,1,1,3,0
5458,Vertebrata,2,1,0,0,1,1,0
546,LECA,2,1,0,0,1,1,0
5466,Opisthokonta,2,0,0,1,1,1,0
5469,Euteleostomi,2,1,0,0,1,1,0
547,LECA,2,1,1,0,0,2,0
5475,LECA,13,1,0,0,12,1,0
5476,Vertebrata,2,0,0,0,2,0,0
5489,LECA,9,0,1,2,6,3,0
549,Opisthokonta,36,2,2,2,30,6,1
55,LECA,4,1,1,0,2,2,0
550,Opisthokonta,7,1,0,2,4,3,1
551,Gnathostomata,2,0,1,0,1,1,0
5514,Gnathostomata,3,0,1,1,1,2,0
5517,LECA,4,1,0,1,2,2,0
5519,Gnathostomata,6,0,1,1,4,2,0
5524,LECA,5,0,0,0,5,0,0
5526,Gnathostomata,2,0,2,0,0,2,0
5529,LECA,3,0,1,0,2,1,0
553,Chordata,7,0,1,0,6,1,0
5532,Opisthokonta,3,1,0,0,2,1,0
5534,Euteleostomi,2,0,0,0,2,0,0
554,Vertebrata,4,0,0,1,3,1,0
5541,LECA,4,0,2,1,1,3,0
5546,Gnathostomata,2,0,1,0,1,1,0
5548,Opisthokonta,2,0,1,0,1,1,0
5549,Opisthokonta,2,0,0,0,2,0,0
555,Vertebrata,2,0,0,0,2,0,0
5555,Opisthokonta,5,2,1,1,1,4,0
5557,Vertebrata,2,0,1,0,1,1,1
556,LECA,3,0,0,0,3,0,0
5560,LECA,2,0,0,0,2,0,0
5568,Bilateria,2,0,0,0,2,0,0
5572,Gnathostomata,6,0,2,0,4,2,1
5584,LECA,2,0,0,0,2,0,0
5585,Gnathostomata,2,0,0,0,2,0,0
5586,LECA,3,0,0,1,2,1,0
5588,Gnathostomata,2,0,0,0,2,0,0
5595,Opisthokonta,3,0,1,1,1,2,0
56,LECA,8,0,0,1,7,1,0
560,LECA,3,1,0,0,2,1,0
5601,Simiiformes,2,1,0,0,1,1,0
5605,Vertebrata,2,0,1,0,1,1,0
561,LECA,20,3,5,8,4,16,3
5616,LECA,5,0,0,0,5,0,0
5627,Gnathostomata,3,0,0,1,2,1,0
5628,Vertebrata,4,1,0,0,3,1,0
563,LECA,4,1,2,0,1,3,0
5631,Gnathostomata,3,1,0,1,1,2,1
564,Chordata,4,1,1,0,2,2,0
5645,Vertebrata,2,0,1,0,1,1,0
5649,LECA,2,0,1,0,1,1,0
565,LECA,2,0,0,0,2,0,0
5653,Vertebrata,2,0,1,0,1,1,0
566,Bilateria,3,1,0,1,1,2,0
5665,Bilateria,2,1,0,0,1,1,0
5666,Opisthokonta,2,0,0,1,1,1,0
567,LECA,7,1,1,3,2,5,2
5671,Chordata,2,1,0,0,1,1,0
5672,Vertebrata,2,0,0,0,2,0,0
5690,LECA,3,1,1,1,0,3,0
5696,LECA,2,0,0,0,2,0,1
57,LECA,34,5,3,4,22,12,1
5700,Bilateria,3,0,0,0,3,0,0
571,LECA,4,1,0,0,3,1,0
5710,Bilateria,3,0,0,0,3,0,0
5716,Gnathostomata,2,0,0,0,2,0,0
572,Gnathostomata,2,0,0,0,2,0,0
5720,Bilateria,2,1,0,1,0,2,0
5724,Gnathostomata,2,1,0,0,1,1,0
5726,Gnathostomata,4,1,1,0,2,2,1
573,Euteleostomi,2,0,0,0,2,0,0
5731,Vertebrata,3,1,1,1,0,3,0
5736,Vertebrata,2,1,1,0,0,2,0
574,LECA,2,0,1,1,0,2,0
5740,Bilateria,2,0,0,0,2,0,0
5746,Eutheria,2,0,0,0,2,0,0
5747,LECA,3,0,0,0,3,0,0
5751,Vertebrata,3,0,0,0,3,0,0
5753,Bilateria,4,1,0,1,2,2,1
576,LECA,7,1,1,1,4,3,0
5765,LECA,2,1,0,1,0,2,0
577,Chordata,3,0,0,1,2,1,0
5770,Gnathostomata,5,0,0,0,5,0,0
5775,Chordata,2,0,0,0,2,0,0
5777,LECA,2,0,0,2,0,2,0
578,LECA,2,0,0,0,2,0,0
5780,Gnathostomata,2,1,0,1,0,2,0
5786,Vertebrata,4,0,0,0,4,0,0
579,LECA,14,2,4,5,3,11,1
5791,LECA,2,1,0,0,1,1,0
5793,LECA,5,0,0,0,5,0,0
58,LECA,4,2,1,1,0,4,0
5800,LECA,4,0,0,0,4,0,0
5803,Chordata,2,0,0,0,2,0,0
5808,LECA,3,0,1,0,2,1,0
581,LECA,5,0,0,0,5,0,0
5810,Chordata,3,0,0,1,2,1,0
5816,Vertebrata,5,0,2,0,3,2,1
5830,LECA,2,0,0,0,2,0,0
5832,Bilateria,2,0,0,0,2,0,0
584,LECA,2,0,0,0,2,0,0
5841,LECA,3,0,0,1,2,1,0
5842,LECA,3,1,0,0,2,1,0
5845,LECA,3,0,2,0,1,2,0
5849,LECA,2,1,0,0,1,1,0
5850,LECA,3,1,0,0,2,1,0
5856,LECA,2,1,1,0,0,2,0
586,LECA,7,1,0,0,6,1,0
5863,Bilateria,2,2,0,0,0,2,0
5866,Bilateria,3,0,0,0,3,0,0
5874,Opisthokonta,3,1,1,0,1,2,0
5878,Chordata,2,1,0,0,1,1,0
5886,LECA,2,0,1,0,1,1,0
589,Bilateria,6,0,1,0,5,1,0
5891,LECA,2,1,0,0,1,1,0
59,LECA,13,1,2,1,9,4,0
590,LECA,36,11,3,1,21,15,2
5907,LECA,2,0,0,0,2,0,0
5909,Gnathostomata,2,0,1,0,1,1,0
5913,Euteleostomi,2,0,0,0,2,0,0
592,LECA,41,5,4,4,28,13,2
5920,Bilateria,2,0,1,0,1,1,0
5932,LECA,2,0,0,0,2,0,0
595,LECA,34,4,6,9,15,19,2
5955,LECA,2,0,2,0,0,2,0
596,Bilateria,2,0,0,0,2,0,0
5963,LECA,2,0,1,0,1,1,0
597,LECA,12,1,0,2,9,3,0
5974,Vertebrata,3,1,0,0,2,1,0
598,LECA,4,0,0,0,4,0,0
5988,Vertebrata,2,0,0,0,2,0,0
5989,LECA,10,2,1,1,6,4,0
599,LECA,14,3,2,0,9,5,0
5994,LECA,4,0,0,2,2,2,0
6,LECA,38,3,4,4,27,11,0
60,LECA,11,0,2,1,8,3,1
600,Gnathostomata,2,0,0,1,1,1,0
6002,Chordata,2,0,0,1,1,1,0
6011,LECA,2,0,0,0,2,0,0
6015,LECA,4,0,0,1,3,1,0
6018,LECA,3,2,0,0,1,2,0
602,LECA,2,0,0,0,2,0,0
6020,Vertebrata,3,1,0,0,2,1,0
6029,LECA,2,0,0,0,2,0,0
603,LECA,12,0,2,0,10,2,1
6040,LECA,2,1,0,0,1,1,0
6047,Vertebrata,2,0,0,0,2,0,0
605,Gnathostomata,2,1,0,0,1,1,0
6050,Vertebrata,2,0,0,1,1,1,0
6053,Gnathostomata,4,0,0,1,3,1,0
6057,Vertebrata,2,1,0,0,1,1,0
606,Gnathostomata,2,1,0,0,1,1,0
6060,Chordata,3,1,0,0,2,1,1
6063,Chordata,2,0,0,0,2,0,0
6069,Gnathostomata,2,0,0,0,2,0,0
607,LECA,4,0,0,1,3,1,0
6075,LECA,2,1,0,0,1,1,1
608,LECA,8,1,1,1,5,3,0
6088,Vertebrata,2,0,0,0,2,0,0
6093,LECA,2,1,0,1,0,2,1
61,LECA,2,0,1,0,1,1,0
610,LECA,20,3,0,5,12,8,1
6105,Bilateria,2,0,1,0,1,1,0
611,Gnathostomata,3,0,0,0,3,0,0
6117,LECA,4,1,0,0,3,1,0
612,Bilateria,3,0,0,1,2,1,0
6122,LECA,2,0,0,0,2,0,0
6129,LECA,3,0,0,0,3,0,1
613,LECA,2,1,0,1,0,2,0
6131,Gnathostomata,2,0,0,0,2,0,0
6138,Gnathostomata,2,2,0,0,0,2,0
614,Chordata,9,1,1,1,6,3,0
6142,LECA,3,0,1,2,0,3,0
6146,LECA,2,1,0,0,1,1,0
6147,Vertebrata,2,0,0,0,2,0,0
6148,Vertebrata,3,1,0,0,2,1,1
6150,Gnathostomata,2,0,0,0,2,0,0
6157,LECA,2,1,0,1,0,2,1
6167,LECA,2,0,1,0,1,1,0
617,LECA,26,1,4,2,19,7,3
6170,Gnathostomata,3,0,0,1,2,1,0
6175,LECA,3,0,0,0,3,0,0
618,Bilateria,15,0,1,1,13,2,1
6185,LECA,3,2,1,0,0,3,0
6193,LECA,2,0,0,1,1,1,0
6195,Eutheria,4,0,0,0,4,0,0
6196,Bilateria,4,1,0,0,3,1,0
620,Bilateria,6,1,0,3,2,4,2
6203,Gnathostomata,2,0,0,0,2,0,0
621,Bilateria,3,0,0,0,3,0,0
6210,LECA,2,0,0,1,1,1,0
6214,Bilateria,3,0,1,1,1,2,1
6217,LECA,2,0,0,0,2,0,0
6219,LECA,6,1,0,1,4,2,0
622,Bilateria,5,0,0,0,5,0,0
623,LECA,2,0,0,0,2,0,0
6231,LECA,4,0,0,0,4,0,0
6240,Bilateria,4,1,1,1,1,3,0
626,LECA,3,0,0,1,2,1,0
6260,Gnathostomata,2,0,0,0,2,0,0
6264,Vertebrata,3,0,0,1,2,1,0
627,LECA,7,0,0,3,4,3,1
628,LECA,5,2,0,2,1,4,0
6287,LECA,2,0,0,0,2,0,0
629,LECA,15,5,1,1,8,7,0
6293,LECA,2,0,0,1,1,1,0
6297,Bilateria,3,0,0,0,3,0,0
63,LECA,2,1,0,0,1,1,1
630,LECA,4,0,1,0,3,1,0
6303,Bilateria,3,1,1,0,1,2,0
6312,LECA,2,1,0,0,1,1,0
6318,LECA,4,0,1,1,2,2,0
632,Bilateria,4,1,1,1,1,3,0
6322,LECA,3,0,0,0,3,0,0
6328,LECA,7,2,1,0,4,3,0
633,Bilateria,6,1,0,2,3,3,0
6337,LECA,3,0,0,0,3,0,0
6347,LECA,3,0,0,0,3,0,0
6351,LECA,2,0,0,0,2,0,0
6364,Vertebrata,2,0,1,0,1,1,0
6366,LECA,2,1,0,0,1,1,0
638,LECA,2,1,1,0,0,2,0
6383,LECA,2,0,2,0,0,2,0
6386,Gnathostomata,2,0,0,0,2,0,0
639,Bilateria,4,0,0,0,4,0,0
6391,LECA,2,1,0,0,1,1,0
6396,Opisthokonta,2,0,0,1,1,1,0
6399,Chordata,3,0,0,0,3,0,0
64,LECA,39,4,4,1,30,9,1
640,LECA,24,1,4,3,16,8,0
6403,LECA,2,0,0,0,2,0,0
6412,Gnathostomata,2,0,0,1,1,1,0
642,LECA,4,0,1,0,3,1,0
6434,Chordata,3,0,1,1,1,2,0
6438,Chordata,2,1,0,0,1,1,0
644,LECA,2,1,0,1,0,2,0
6442,LECA,2,1,1,0,0,2,0
645,LECA,4,0,1,2,1,3,0
6451,Gnathostomata,2,0,0,1,1,1,0
646,Vertebrata,2,1,0,1,0,2,0
647,LECA,9,2,1,0,6,3,1
6470,LECA,3,0,0,0,3,0,0
6477,Bilateria,2,1,0,0,1,1,0
6479,Gnathostomata,2,0,0,0,2,0,0
648,Eutheria,2,1,0,0,1,1,0
6483,LECA,3,1,1,0,1,2,0
6484,Vertebrata,3,1,1,0,1,2,0
6486,LECA,3,0,1,0,2,1,0
649,LECA,2,0,1,0,1,1,0
6494,LECA,3,1,0,1,1,2,0
65,LECA,2,0,0,1,1,1,0
650,LECA,9,1,1,1,6,3,0
6500,LECA,4,0,2,0,2,2,0
651,Opisthokonta,3,1,0,0,2,1,0
6511,Gnathostomata,3,1,0,1,1,2,0
652,Bilateria,5,0,3,1,1,4,0
6529,LECA,2,0,0,0,2,0,0
6539,Euteleostomi,2,0,0,1,1,1,0
6543,Vertebrata,5,0,0,1,4,1,0
655,LECA,10,0,0,2,8,2,0
6553,LECA,2,0,0,1,1,1,0
6554,Bilateria,6,1,1,0,4,2,1
6576,LECA,4,1,0,1,2,2,0
6577,LECA,3,0,1,0,2,1,0
6583,LECA,6,0,0,1,5,1,0
659,LECA,7,0,0,0,7,0,0
66,LECA,19,3,5,0,11,8,1
660,LECA,2,0,1,0,1,1,0
661,Vertebrata,2,1,0,0,1,1,0
662,LECA,16,1,2,3,10,6,1
663,Bilateria,10,1,0,3,6,4,0
6634,LECA,2,0,0,0,2,0,0
6647,Amniota,2,0,0,0,2,0,0
668,LECA,2,0,0,0,2,0,0
6685,LECA,2,0,1,0,1,1,0
6688,LECA,4,0,1,0,3,1,0
6689,LECA,21,1,4,6,10,11,1
669,LECA,2,2,0,0,0,2,0
67,LECA,2,0,2,0,0,2,0
670,LECA,5,1,0,2,2,3,0
6704,Vertebrata,2,0,0,1,1,1,0
671,Vertebrata,2,0,0,0,2,0,0
6716,LECA,2,0,0,1,1,1,0
6719,Bilateria,2,0,1,0,1,1,0
673,LECA,3,0,0,0,3,0,0
6731,LECA,3,0,1,0,2,1,0
6741,LECA,2,0,0,0,2,0,0
6745,LECA,2,0,0,1,1,1,0
676,LECA,4,0,0,2,2,2,0
677,LECA,2,0,2,0,0,2,0
6775,Chordata,2,1,0,0,1,1,0
678,LECA,18,5,0,0,13,5,1
679,Bilateria,2,0,0,1,1,1,0
6795,Vertebrata,2,0,0,0,2,0,0
6798,LECA,2,0,0,0,2,0,0
68,LECA,4,0,0,1,3,1,0
6800,Gnathostomata,3,0,1,0,2,1,0
6809,Gnathostomata,2,0,0,1,1,1,1
6824,LECA,2,1,0,0,1,1,0
6830,LECA,2,0,0,0,2,0,0
684,Gnathostomata,2,1,1,0,0,2,0
6841,LECA,2,0,0,2,0,2,0
6846,Vertebrata,2,0,0,1,1,1,0
685,LECA,3,0,2,0,1,2,0
6867,LECA,2,0,0,0,2,0,0
6874,LECA,2,0,0,0,2,0,0
6879,Tetrapoda,2,0,0,1,1,1,0
688,LECA,6,0,1,1,4,2,0
6880,Vertebrata,2,0,0,0,2,0,0
689,LECA,4,1,1,1,1,3,0
69,LECA,3,1,0,0,2,1,0
690,LECA,6,0,1,1,4,2,0
6901,LECA,3,0,2,0,1,2,0
6907,Gnathostomata,2,0,0,0,2,0,0
6909,Gnathostomata,2,0,0,0,2,0,0
6913,Chordata,2,0,0,0,2,0,0
6927,Gnathostomata,2,0,0,0,2,0,0
693,LECA,2,0,1,1,0,2,1
6936,Bilateria,2,0,1,0,1,1,0
6942,Bilateria,3,0,0,0,3,0,1
6943,LECA,2,0,1,0,1,1,0
6944,LECA,2,0,1,0,1,1,0
6948,Vertebrata,3,1,0,0,2,1,0
695,Vertebrata,2,0,0,0,2,0,0
6950,LECA,4,0,1,0,3,1,0
6957,LECA,4,1,0,0,3,1,0
6967,LECA,4,0,1,1,2,2,0
697,LECA,13,2,0,0,11,2,1
6970,Chordata,4,0,0,1,3,1,0
6975,Amniota,2,0,0,0,2,0,0
6976,LECA,3,0,0,2,1,2,1
698,Bilateria,2,0,0,0,2,0,0
6984,Bilateria,2,0,0,0,2,0,0
699,LECA,6,2,1,1,2,4,0
6994,Bilateria,2,1,0,0,1,1,0
6997,Gnathostomata,2,0,0,0,2,0,0
7,Vertebrata,2,1,0,0,1,1,1
70,LECA,18,0,2,0,16,2,0
7002,LECA,3,1,0,1,1,2,0
7006,LECA,2,0,0,1,1,1,0
7008,LECA,3,0,0,1,2,1,0
7009,LECA,3,1,0,0,2,1,0
701,Chordata,2,1,0,0,1,1,0
7010,Gnathostomata,2,0,0,0,2,0,0
7013,Gnathostomata,2,0,0,1,1,1,0
703,LECA,34,5,4,1,24,10,3
7031,LECA,6,1,0,0,5,1,0
7046,Vertebrata,3,0,0,1,2,1,0
705,Bilateria,6,3,1,0,2,4,0
7050,Homininae,2,1,0,0,1,1,0
7058,Bilateria,2,0,1,0,1,1,0
706,LECA,5,0,1,0,4,1,0
7060,Bilateria,2,0,0,0,2,0,0
7066,Opisthokonta,2,0,0,0,2,0,0
707,Opisthokonta,5,1,1,1,2,3,0
7073,LECA,4,0,1,0,3,1,0
7075,LECA,4,0,0,1,3,1,0
709,LECA,2,1,0,0,1,1,0
7096,Vertebrata,5,1,0,0,4,1,0
7098,Gnathostomata,2,1,1,0,0,2,0
71,LECA,11,1,5,3,2,9,1
7109,Euteleostomi,2,0,0,0,2,0,0
711,LECA,2,0,0,0,2,0,0
7120,Gnathostomata,2,1,0,1,0,2,0
7125,LECA,2,0,0,1,1,1,0
713,Bilateria,6,1,0,1,4,2,0
714,Bilateria,6,1,1,0,4,2,0
7143,LECA,2,0,0,0,2,0,0
7147,Euteleostomi,2,1,0,1,0,2,0
7156,LECA,2,0,0,0,2,0,0
7159,Sarcopterygii,2,0,0,0,2,0,0
7165,Opisthokonta,3,0,0,0,3,0,0
7174,LECA,3,1,0,0,2,1,0
7179,Euteleostomi,2,0,0,1,1,1,0
7199,Euteleostomi,9,1,1,0,7,2,0
72,LECA,6,1,1,1,3,3,0
720,LECA,2,0,0,1,1,1,0
7201,Opisthokonta,2,0,0,1,1,1,0
7209,Gnathostomata,2,0,0,0,2,0,0
721,LECA,2,1,0,0,1,1,0
722,LECA,4,0,1,0,3,1,0
7221,Vertebrata,2,0,0,0,2,0,0
7223,LECA,4,0,1,0,3,1,0
7224,LECA,3,1,0,1,1,2,1
723,Vertebrata,2,0,0,0,2,0,0
7231,LECA,2,0,0,0,2,0,0
724,Chordata,19,2,1,1,15,4,1
7241,Hominoidea,2,0,0,1,1,1,0
7242,Vertebrata,2,0,0,0,2,0,0
7249,Bilateria,3,0,1,0,2,1,0
725,LECA,3,0,1,0,2,1,0
7253,Gnathostomata,2,0,0,0,2,0,0
726,LECA,2,1,0,1,0,2,0
7262,Bilateria,10,1,0,3,6,4,0
727,Opisthokonta,9,0,1,0,8,1,0
7272,LECA,2,0,0,0,2,0,0
728,LECA,2,0,0,0,2,0,0
7283,Euteleostomi,2,0,0,0,2,0,0
7284,Amniota,2,0,0,1,1,1,0
7288,LECA,2,0,0,0,2,0,0
729,Bilateria,4,1,0,0,3,1,0
7298,Euteleostomi,2,0,0,1,1,1,0
73,LECA,4,1,0,1,2,2,0
730,LECA,6,4,0,1,1,5,0
7304,LECA,6,0,1,1,4,2,0
7305,LECA,4,0,1,0,3,1,0
731,LECA,11,0,1,1,9,2,1
7319,Eutheria,2,1,0,0,1,1,0
732,LECA,38,2,9,6,21,17,2
7325,Gnathostomata,2,0,0,0,2,0,0
7328,Vertebrata,7,1,0,1,5,2,0
733,LECA,12,2,0,1,9,3,0
7335,Chordata,3,1,0,0,2,1,0
7337,Bilateria,3,0,0,0,3,0,0
7338,Gnathostomata,3,0,0,0,3,0,0
734,LECA,2,0,0,0,2,0,0
7341,LECA,2,1,0,0,1,1,0
7352,LECA,5,0,0,0,5,0,0
7356,LECA,4,1,0,0,3,1,0
736,LECA,7,1,1,0,5,2,0
737,LECA,2,1,0,0,1,1,0
7370,Sarcopterygii,2,0,1,1,0,2,0
738,LECA,4,2,0,0,2,2,0
7381,Vertebrata,2,0,0,0,2,0,0
74,Vertebrata,2,0,0,0,2,0,0
742,Bilateria,2,0,0,1,1,1,0
7421,Bilateria,2,0,0,0,2,0,0
7425,LECA,2,0,1,1,0,2,0
7427,Gnathostomata,2,0,0,0,2,0,0
7432,LECA,2,0,1,0,1,1,1
7435,LECA,2,0,0,1,1,1,0
7438,LECA,2,0,1,0,1,1,0
744,LECA,4,1,3,0,0,4,0
745,Opisthokonta,2,1,0,0,1,1,0
7450,Gnathostomata,2,0,0,0,2,0,0
746,Gnathostomata,2,0,1,1,0,2,0
7469,LECA,2,0,0,0,2,0,0
748,LECA,6,0,1,2,3,3,0
7481,LECA,3,0,0,1,2,1,0
749,Opisthokonta,5,1,1,0,3,2,0
7493,LECA,2,1,0,0,1,1,0
75,LECA,2,0,0,0,2,0,0
750,LECA,2,0,0,0,2,0,0
7502,Vertebrata,4,1,1,0,2,2,0
7503,Amniota,2,0,0,0,2,0,0
7509,Bilateria,3,0,1,1,1,2,0
7517,Homo sapiens,2,1,0,1,0,2,0
7519,Homininae,2,0,0,0,2,0,0
752,LECA,3,1,0,1,1,2,0
7525,Vertebrata,3,0,0,0,3,0,0
7547,LECA,2,0,0,0,2,0,0
757,LECA,3,0,0,0,3,0,1
7574,LECA,2,1,0,0,1,1,0
758,Vertebrata,4,0,2,1,1,3,0
759,LECA,5,0,1,0,4,1,0
7591,Vertebrata,2,0,0,0,2,0,0
76,LECA,4,0,0,1,3,1,1
7606,LECA,2,0,0,0,2,0,0
7614,Gnathostomata,2,0,0,0,2,0,0
7616,Vertebrata,2,0,1,0,1,1,0
7620,Vertebrata,3,0,0,0,3,0,0
7624,Vertebrata,2,0,0,1,1,1,0
763,LECA,8,1,1,1,5,3,0
7635,LECA,2,0,1,0,1,1,0
7643,Bilateria,2,0,1,0,1,1,0
7645,Gnathostomata,2,0,0,0,2,0,0
765,LECA,9,1,0,4,4,5,1
7657,Gnathostomata,2,1,0,0,1,1,0
766,Vertebrata,2,0,1,0,1,1,0
7672,Bilateria,2,0,0,0,2,0,0
768,LECA,5,0,1,1,3,2,0
7687,Vertebrata,2,0,0,0,2,0,0
7693,LECA,2,0,1,1,0,2,0
77,LECA,3,0,0,1,2,1,0
770,LECA,11,1,0,4,6,5,0
772,LECA,6,3,0,1,2,4,1
7722,LECA,3,1,0,0,2,1,0
7726,Gnathostomata,2,0,0,0,2,0,0
773,LECA,6,2,1,0,3,3,1
7733,Vertebrata,2,0,1,0,1,1,0
7737,Bilateria,4,0,2,0,2,2,0
7741,Eutheria,2,0,1,0,1,1,0
775,Vertebrata,2,0,0,0,2,0,0
7755,Gnathostomata,4,0,1,0,3,1,0
776,Vertebrata,3,1,1,1,0,3,1
7761,Bilateria,2,1,0,0,1,1,0
7767,LECA,2,1,0,0,1,1,0
7774,Gnathostomata,2,0,0,0,2,0,0
7785,Vertebrata,2,0,1,0,1,1,0
779,LECA,4,0,1,0,3,1,0
78,LECA,2,0,0,1,1,1,0
780,LECA,10,0,1,1,8,2,0
7806,LECA,2,0,1,0,1,1,1
7810,LECA,2,0,0,0,2,0,0
7819,Bilateria,5,2,0,0,3,2,0
783,LECA,19,2,1,1,15,4,1
784,LECA,5,1,0,2,2,3,0
7849,Boreoeutheria,2,1,0,0,1,1,0
7856,LECA,3,0,1,0,2,1,0
786,LECA,23,5,3,7,8,15,2
7860,Vertebrata,2,0,1,0,1,1,0
7868,Bilateria,4,0,0,0,4,0,0
7869,LECA,2,0,0,0,2,0,0
788,Bilateria,3,1,1,0,1,2,0
7888,LECA,2,1,1,0,0,2,0
789,Opisthokonta,3,0,0,3,0,3,0
79,LECA,4,1,1,0,2,2,0
7900,LECA,2,1,1,0,0,2,0
7903,Tetrapoda,3,0,0,0,3,0,0
791,LECA,3,2,0,0,1,2,0
7913,Eutheria,2,0,0,0,2,0,0
7919,Bilateria,3,0,0,0,3,0,0
792,LECA,2,0,1,0,1,1,1
7923,LECA,2,0,0,0,2,0,0
7932,LECA,2,0,0,0,2,0,0
7944,LECA,11,3,1,1,6,5,1
7946,LECA,2,1,0,0,1,1,0
795,LECA,8,0,1,0,7,1,0
7952,Opisthokonta,2,2,0,0,0,2,0
7953,Bilateria,2,1,0,0,1,1,0
7954,Chordata,3,1,1,0,1,2,0
7960,LECA,2,0,0,0,2,0,0
7965,Vertebrata,4,0,0,2,2,2,0
799,LECA,3,1,1,0,1,2,0
7998,Vertebrata,3,0,1,0,2,1,0
8,LECA,4,0,0,0,4,0,0
80,LECA,6,0,2,1,3,3,1
800,Vertebrata,2,0,0,0,2,0,0
8011,Gnathostomata,2,0,0,1,1,1,0
8015,LECA,3,0,1,0,2,1,0
803,LECA,2,0,0,0,2,0,0
8055,Bilateria,2,0,1,0,1,1,0
8060,Chordata,3,1,0,0,2,1,0
807,LECA,10,0,1,0,9,1,0
8081,LECA,2,0,0,0,2,0,0
809,LECA,2,0,0,1,1,1,0
8093,Vertebrata,2,0,0,0,2,0,0
81,Theria,3,1,0,1,1,2,0
8103,LECA,3,0,0,0,3,0,0
8112,LECA,2,0,0,1,1,1,0
8122,Chordata,3,0,2,0,1,2,0
8124,Chordata,2,0,0,0,2,0,0
813,Vertebrata,3,0,1,0,2,1,0
8130,Gnathostomata,2,0,1,0,1,1,0
8136,LECA,3,0,0,1,2,1,0
814,LECA,3,2,0,0,1,2,0
8148,Vertebrata,2,0,0,0,2,0,0
8165,Euteleostomi,2,0,1,0,1,1,0
817,LECA,3,0,1,1,1,2,0
818,LECA,2,1,0,0,1,1,0
8196,Vertebrata,2,1,1,0,0,2,0
8197,Theria,12,1,1,0,10,2,1
82,Gnathostomata,2,0,0,0,2,0,0
820,LECA,20,1,1,6,12,8,1
8205,Bilateria,2,0,1,0,1,1,0
821,LECA,7,1,1,0,5,2,0
8214,LECA,2,0,1,0,1,1,0
8220,Gnathostomata,3,1,1,0,1,2,0
8224,Vertebrata,2,0,1,0,1,1,0
8239,LECA,2,0,1,0,1,1,0
8240,LECA,5,0,1,0,4,1,0
8241,LECA,3,0,0,0,3,0,0
8248,Opisthokonta,3,1,1,0,1,2,0
8252,LECA,3,2,0,0,1,2,0
826,LECA,4,0,0,0,4,0,0
8262,LECA,3,1,1,0,1,2,1
8264,LECA,2,0,1,0,1,1,0
8279,LECA,2,0,0,0,2,0,0
828,LECA,5,0,2,0,3,2,0
8281,LECA,3,0,0,1,2,1,0
829,LECA,2,1,0,0,1,1,0
83,LECA,13,1,2,1,9,4,1
8301,Bilateria,3,0,1,0,2,1,0
8318,Sarcopterygii,3,0,0,0,3,0,0
8332,Vertebrata,2,0,0,1,1,1,0
8352,Euteleostomi,2,0,0,0,2,0,0
8355,Amniota,3,0,1,0,2,1,1
8365,Gnathostomata,3,1,1,0,1,2,0
8369,Gnathostomata,3,0,1,0,2,1,0
8371,LECA,2,0,0,1,1,1,0
8373,Theria,2,0,0,0,2,0,0
838,LECA,2,0,0,0,2,0,0
839,Opisthokonta,3,1,1,1,0,3,0
84,LECA,7,0,1,2,4,3,0
840,LECA,3,1,0,0,2,1,0
8410,Bilateria,3,1,0,1,1,2,0
842,LECA,6,2,0,0,4,2,0
8436,LECA,3,0,1,0,2,1,0
844,Vertebrata,4,0,0,1,3,1,0
846,Bilateria,6,0,0,0,6,0,0
8460,Gnathostomata,2,0,0,0,2,0,0
848,Gnathostomata,3,3,0,0,0,3,0
8485,Opisthokonta,2,0,0,0,2,0,0
849,Opisthokonta,2,0,0,0,2,0,0
8495,LECA,3,0,0,2,1,2,0
8496,Bilateria,2,0,0,0,2,0,0
850,LECA,5,0,0,0,5,0,0
851,LECA,6,0,0,0,6,0,0
8511,Euteleostomi,2,0,0,1,1,1,0
8512,Vertebrata,4,1,0,0,3,1,0
852,Bilateria,4,0,0,1,3,1,0
8523,Bilateria,3,0,1,0,2,1,0
8536,Bilateria,2,0,0,0,2,0,0
854,LECA,13,0,3,4,6,7,1
855,LECA,3,0,1,1,1,2,0
856,Vertebrata,3,1,0,0,2,1,0
8562,Vertebrata,2,1,0,0,1,1,0
857,LECA,6,0,0,0,6,0,0
859,LECA,3,0,0,1,2,1,0
86,Opisthokonta,2,0,1,0,1,1,0
860,Vertebrata,3,0,0,0,3,0,0
8615,Opisthokonta,2,0,0,0,2,0,0
862,LECA,7,1,0,0,6,1,0
8623,Bilateria,2,0,0,0,2,0,0
8627,Gnathostomata,2,1,0,0,1,1,0
863,LECA,8,1,0,0,7,1,0
8647,LECA,3,1,0,0,2,1,0
8653,Catarrhini,2,1,1,0,0,2,0
866,LECA,2,0,0,0,2,0,0
867,LECA,7,0,2,0,5,2,0
8672,Chordata,2,0,0,0,2,0,0
8674,LECA,2,0,1,1,0,2,0
8677,Euteleostomi,2,0,0,1,1,1,0
868,Bilateria,2,0,0,0,2,0,0
8685,Vertebrata,3,0,0,0,3,0,0
87,Chordata,3,0,0,0,3,0,0
870,Vertebrata,3,0,2,0,1,2,0
8707,LECA,2,1,1,0,0,2,0
871,Eutheria,8,0,1,0,7,1,0
8714,LECA,3,0,1,1,1,2,0
8717,Gnathostomata,2,0,0,0,2,0,0
873,LECA,6,0,0,1,5,1,0
8734,Eutheria,4,0,1,1,2,2,0
874,LECA,14,3,0,1,10,4,0
8745,Euteleostomi,2,1,0,0,1,1,0
8749,LECA,2,1,0,0,1,1,0
8759,LECA,2,0,1,0,1,1,0
878,Gnathostomata,2,0,0,1,1,1,0
879,LECA,4,1,1,1,1,3,0
88,LECA,21,1,2,3,15,6,2
880,Chordata,10,1,3,0,6,4,0
8807,Vertebrata,2,0,0,0,2,0,0
8824,Opisthokonta,3,0,0,0,3,0,0
8829,LECA,2,0,1,0,1,1,0
883,Bilateria,20,4,1,2,13,7,0
8839,LECA,4,1,0,0,3,1,0
884,Bilateria,2,1,0,0,1,1,0
8841,Vertebrata,2,0,1,0,1,1,0
8862,LECA,2,0,0,0,2,0,0
887,Bilateria,22,2,0,2,18,4,1
888,Gnathostomata,2,0,0,1,1,1,1
8880,LECA,2,1,0,0,1,1,0
889,Bilateria,8,0,4,0,4,4,0
89,LECA,133,9,7,12,105,28,3
890,Opisthokonta,10,2,0,3,5,5,0
891,Bilateria,5,1,1,0,3,2,1
893,LECA,3,0,1,1,1,2,0
895,LECA,5,2,1,2,0,5,0
8964,Vertebrata,2,0,1,0,1,1,0
897,Opisthokonta,2,0,1,0,1,1,0
8978,LECA,2,0,0,1,1,1,0
898,LECA,16,2,5,2,7,9,2
8980,Gnathostomata,3,0,0,0,3,0,0
8982,Vertebrata,2,0,0,0,2,0,1
8983,Simiiformes,2,0,0,0,2,0,0
9,LECA,3,0,1,0,2,1,0
90,LECA,2,0,1,0,1,1,0
900,LECA,3,0,0,1,2,1,0
9004,LECA,4,1,1,0,2,2,0
9006,Bilateria,2,0,0,0,2,0,0
901,Gnathostomata,2,1,0,0,1,1,0
902,Vertebrata,2,0,0,1,1,1,0
9020,Primates,4,0,2,1,1,3,0
9039,Vertebrata,2,0,0,0,2,0,0
905,LECA,9,3,0,2,4,5,1
9053,Gnathostomata,2,0,0,0,2,0,0
9054,Vertebrata,2,0,0,0,2,0,0
906,Bilateria,20,1,1,0,18,2,0
907,LECA,4,1,0,1,2,2,0
908,LECA,3,0,1,0,2,1,0
9080,LECA,4,0,0,0,4,0,0
9088,LECA,2,0,0,0,2,0,0
91,LECA,17,3,1,1,12,5,1
911,LECA,3,1,2,0,0,3,0
9129,LECA,2,0,0,1,1,1,0
9132,Gnathostomata,2,0,1,0,1,1,0
914,Bilateria,3,0,0,0,3,0,0
9144,Opisthokonta,2,0,0,2,0,2,0
915,Opisthokonta,4,0,0,1,3,1,0
9156,Gnathostomata,2,0,0,0,2,0,0
9164,Bilateria,2,0,1,0,1,1,0
917,LECA,4,1,0,0,3,1,0
9174,Vertebrata,2,2,0,0,0,2,0
918,Gnathostomata,2,0,0,0,2,0,0
9190,Bilateria,2,1,0,0,1,1,0
9193,LECA,2,1,0,1,0,2,1
9198,LECA,2,0,0,0,2,0,0
92,LECA,18,0,4,3,11,7,2
920,LECA,2,0,1,0,1,1,0
9214,Eutheria,2,0,1,1,0,2,0
9215,LECA,2,0,0,0,2,0,0
9231,LECA,10,0,1,0,9,1,1
9239,LECA,2,1,0,1,0,2,0
9251,LECA,2,1,0,0,1,1,0
9269,LECA,2,0,1,0,1,1,0
927,LECA,2,0,0,0,2,0,0
9278,Bilateria,2,0,0,1,1,1,0
928,LECA,3,0,0,1,2,1,1
930,Opisthokonta,4,1,1,1,1,3,0
9307,LECA,3,0,1,0,2,1,0
9356,Euteleostomi,2,0,0,0,2,0,0
9368,LECA,2,0,0,1,1,1,0
937,LECA,7,1,0,0,6,1,0
9374,Chordata,2,0,1,0,1,1,0
9376,LECA,2,1,1,0,0,2,1
9382,Euteleostomi,12,0,0,2,10,2,0
9397,Eutheria,2,0,0,0,2,0,0
940,Bilateria,3,1,0,0,2,1,0
941,Bilateria,4,0,0,0,4,0,0
9417,Gnathostomata,2,0,0,0,2,0,0
942,Chordata,7,2,0,1,4,3,1
9428,Vertebrata,3,0,0,0,3,0,0
943,Bilateria,4,0,2,0,2,2,0
944,LECA,8,2,1,3,2,6,0
9449,Vertebrata,2,0,0,1,1,1,0
945,LECA,5,1,0,0,4,1,0
946,LECA,2,0,0,0,2,0,0
9460,LECA,2,0,0,0,2,0,0
947,LECA,4,1,1,1,1,3,0
948,LECA,4,0,0,1,3,1,0
95,LECA,32,4,1,5,22,10,1
950,Bilateria,3,0,1,1,1,2,0
9503,Euteleostomi,4,1,1,0,2,2,0
951,LECA,4,0,0,1,3,1,0
9510,LECA,2,0,1,0,1,1,0
9517,LECA,2,0,0,0,2,0,0
952,LECA,32,6,5,7,14,18,2
9528,LECA,3,0,0,1,2,1,0
953,LECA,5,0,1,0,4,1,0
954,LECA,33,3,9,7,14,19,0
9542,LECA,10,2,1,1,6,4,0
9543,Eutheria,2,0,0,0,2,0,0
9544,Gnathostomata,2,0,0,0,2,0,0
955,LECA,2,1,0,1,0,2,0
956,Vertebrata,4,1,0,1,2,2,0
9566,LECA,2,0,1,0,1,1,0
9567,Bilateria,2,1,0,0,1,1,0
957,LECA,2,0,0,0,2,0,0
9570,Bilateria,2,0,0,1,1,1,0
9573,LECA,2,0,0,1,1,1,0
9581,Vertebrata,2,0,0,1,1,1,0
96,Chordata,3,0,0,3,0,3,0
9633,Gnathostomata,2,0,0,0,2,0,1
9638,Chordata,2,1,1,0,0,2,0
964,LECA,7,2,1,2,2,5,0
9641,LECA,2,0,0,0,2,0,0
9655,LECA,3,0,0,0,3,0,0
9673,Amniota,2,0,0,0,2,0,1
971,LECA,3,0,0,0,3,0,0
9712,LECA,2,1,0,0,1,1,0
972,Bilateria,8,0,0,0,8,0,0
9729,LECA,2,0,0,0,2,0,0
973,LECA,9,0,3,1,5,4,0
9739,LECA,2,0,0,1,1,1,0
974,LECA,6,1,1,0,4,2,0
9741,LECA,3,1,0,1,1,2,0
9742,Gnathostomata,4,0,1,0,3,1,0
9745,Gnathostomata,2,0,2,0,0,2,0
9747,Vertebrata,2,0,0,1,1,1,0
9755,LECA,3,0,0,0,3,0,0
976,LECA,5,0,1,0,4,1,0
977,Opisthokonta,4,1,0,1,2,2,0
9782,LECA,2,0,0,0,2,0,0
979,Vertebrata,4,0,1,1,2,2,0
9790,Gnathostomata,2,0,2,0,0,2,0
9798,LECA,2,0,0,0,2,0,0
98,Opisthokonta,8,0,2,1,5,3,0
980,LECA,12,3,5,0,4,8,0
981,LECA,8,0,1,0,7,1,0
9810,Bilateria,2,0,0,1,1,1,0
9820,Vertebrata,2,0,0,0,2,0,0
983,LECA,8,0,2,1,5,3,0
986,LECA,12,3,2,3,4,8,1
987,LECA,4,0,0,0,4,0,0
9871,Homininae,3,0,0,1,2,1,0
9874,Tetrapoda,2,0,0,0,2,0,0
988,Gnathostomata,13,0,1,2,10,3,0
989,Bilateria,5,0,3,0,2,3,0
99,LECA,5,0,0,0,5,0,0
990,Opisthokonta,15,1,3,2,9,6,0
994,Bilateria,6,0,2,0,4,2,0
9944,Vertebrata,2,0,1,0,1,1,0
9946,Euteleostomi,3,0,1,0,2,1,0
995,LECA,2,0,1,0,1,1,0
9956,Gnathostomata,2,0,0,0,2,0,0
9957,LECA,2,0,0,0,2,0,1
996,LECA,3,0,0,0,3,0,0
9960,LECA,2,1,0,1,0,2,0
9962,LECA,2,0,0,0,2,0,0
9971,Gnathostomata,2,0,1,0,1,1,0
998,Gnathostomata,2,0,1,0,1,1,0
999,Gnathostomata,2,0,0,0,2,0,0
9995,LECA,2,0,0,0,2,0,1
0,NA,3606,382,460,401,2363,1243,91
